,Load,Wind,Solar,Nuclear,NetLoad1,DispGen,NetLoad2
1/1/2016 0:00,33853,4365,0,4712,24776,22821,1955
1/1/2016 1:00,33853,4491,0,4712,24650,22362,2288
1/1/2016 2:00,33434,4458,0,4712,24264,22039,2225
1/1/2016 3:00,33099,4665,0,4712,23722,21903,1819
1/1/2016 4:00,33054,4691,0,4712,23651,22214,1437
1/1/2016 5:00,33442,4678,0,4712,24052,23304,748
1/1/2016 6:00,34400,4551,0,4712,25137,23863,1274
1/1/2016 7:00,35396,4339,0,4712,26345,24592,1753
1/1/2016 8:00,36094,3839,0,4712,27544,25711,1833
1/1/2016 9:00,36858,3739,26,4712,28380,26710,1670
1/1/2016 10:00,38057,3485,31,4712,29830,27630,2200
1/1/2016 11:00,38761,3285,46,4712,30718,27891,2827
1/1/2016 12:00,38880,3229,52,4712,30888,27989,2899
1/1/2016 13:00,38613,2461,63,4712,31377,27896,3481
1/1/2016 14:00,38104,2322,59,4712,31011,27285,3726
1/1/2016 15:00,37616,2302,41,4712,30562,27335,3227
1/1/2016 16:00,37481,2163,24,4712,30581,27742,2839
1/1/2016 17:00,37924,1985,29,4712,31198,29718,1480
1/1/2016 18:00,39874,2054,0,4712,33109,31001,2108
1/1/2016 19:00,41171,2275,0,4712,34184,30754,3430
1/1/2016 20:00,40902,2259,0,4712,33931,30450,3481
1/1/2016 21:00,40525,2093,0,4712,33720,29826,3894
1/1/2016 22:00,39775,2065,0,4712,32998,28440,4558
1/1/2016 23:00,38564,2228,0,4712,31625,26987,4638
1/2/2016 0:00,37005,2103,0,4712,30190,25931,4259
1/2/2016 1:00,35640,2526,0,4712,28402,24970,3432
1/2/2016 2:00,34752,2450,0,4712,27589,24670,2919
1/2/2016 3:00,34191,2481,0,4712,26998,24422,2576
1/2/2016 4:00,33907,2412,0,4712,26783,24516,2267
1/2/2016 5:00,34180,2472,0,4712,26997,25042,1955
1/2/2016 6:00,35017,2588,0,4712,27717,25637,2080
1/2/2016 7:00,36244,2496,0,4712,29036,26886,2150
1/2/2016 8:00,37557,2092,0,4712,30753,28590,2163
1/2/2016 9:00,38739,1646,22,4712,32359,30608,1751
1/2/2016 10:00,40104,1563,30,4712,33798,31521,2277
1/2/2016 11:00,40749,1358,42,4712,34637,31805,2832
1/2/2016 12:00,40596,839,49,4712,34996,31365,3631
1/2/2016 13:00,40021,1067,49,4712,34193,30281,3912
1/2/2016 14:00,39036,1136,44,4712,33144,29432,3712
1/2/2016 15:00,38217,1275,43,4712,32187,28802,3385
1/2/2016 16:00,37921,1034,46,4712,32129,28947,3182
1/2/2016 17:00,38243,921,32,4712,32578,30986,1592
1/2/2016 18:00,40018,967,0,4712,34339,31992,2347
1/2/2016 19:00,41323,1373,0,4712,35238,31509,3729
1/2/2016 20:00,41060,1948,0,4712,34401,30618,3783
1/2/2016 21:00,40569,2158,0,4712,33700,29370,4330
1/2/2016 22:00,39660,2575,0,4712,32373,27918,4455
1/2/2016 23:00,38215,2888,0,4712,30614,26311,4303
1/3/2016 0:00,36512,3150,0,4712,28650,25008,3642
1/3/2016 1:00,35150,3552,0,4712,26886,24120,2766
1/3/2016 2:00,34306,3720,0,4712,25874,23750,2124
1/3/2016 3:00,33941,3836,0,4712,25393,23517,1876
1/3/2016 4:00,33960,4111,0,4712,25138,23897,1241
1/3/2016 5:00,34378,3875,0,4712,25791,24637,1154
1/3/2016 6:00,35319,3823,0,4712,26784,25369,1415
1/3/2016 7:00,36688,3279,0,4712,28698,26774,1924
1/3/2016 8:00,37986,2905,14,4712,30354,27936,2418
1/3/2016 9:00,38542,2396,189,4712,31245,28272,2973
1/3/2016 10:00,38095,1464,238,4712,31681,27637,4044
1/3/2016 11:00,36892,1293,274,4712,30613,26407,4206
1/3/2016 12:00,35485,1520,314,4712,28940,24926,4014
1/3/2016 13:00,34274,1514,327,4712,27722,24349,3373
1/3/2016 14:00,33194,1432,305,4712,26744,23744,3000
1/3/2016 15:00,32352,1378,271,4712,25991,23356,2635
1/3/2016 16:00,31938,1339,231,4712,25656,23649,2007
1/3/2016 17:00,32134,980,213,4712,26230,25088,1142
1/3/2016 18:00,34112,1180,0,4712,28220,27574,646
1/3/2016 19:00,37128,2132,0,4712,30284,27440,2844
1/3/2016 20:00,37908,2751,0,4712,30446,27572,2874
1/3/2016 21:00,37988,2423,0,4712,30853,27547,3306
1/3/2016 22:00,37608,2280,0,4712,30616,26318,4298
1/3/2016 23:00,36279,2028,0,4712,29539,25500,4039
1/4/2016 0:00,34745,1954,0,4712,28080,24938,3142
1/4/2016 1:00,33859,1932,0,4712,27215,24596,2619
1/4/2016 2:00,33687,2409,0,4712,26565,24707,1858
1/4/2016 3:00,34027,2501,0,4712,26814,25293,1521
1/4/2016 4:00,34856,2372,0,4712,27773,26500,1273
1/4/2016 5:00,36609,2431,0,4712,29466,29634,-168
1/4/2016 6:00,39916,1853,0,4712,33351,33523,-172
1/4/2016 7:00,44061,1347,0,4712,38003,35252,2751
1/4/2016 8:00,45767,1101,25,4712,39929,35037,4892
1/4/2016 9:00,44707,736,243,4712,39016,33914,5102
1/4/2016 10:00,42998,363,302,4712,37620,32167,5453
1/4/2016 11:00,41219,420,305,4712,35783,30393,5390
1/4/2016 12:00,39390,480,324,4712,33875,28978,4897
1/4/2016 13:00,37761,458,328,4712,32263,28050,4213
1/4/2016 14:00,36580,475,303,4712,31089,27085,4004
1/4/2016 15:00,35564,746,274,4712,29833,26507,3326
1/4/2016 16:00,34925,1131,234,4712,28848,26032,2816
1/4/2016 17:00,34968,1354,163,4712,28740,27606,1134
1/4/2016 18:00,37134,1762,0,4712,30660,29940,720
1/4/2016 19:00,40482,3058,0,4712,32712,29416,3296
1/4/2016 20:00,41219,4136,0,4712,32371,29129,3242
1/4/2016 21:00,41443,4386,0,4712,32346,27965,4381
1/4/2016 22:00,40609,5019,0,4712,30878,26171,4707
1/4/2016 23:00,38585,5077,0,4712,28796,24331,4465
1/5/2016 0:00,36626,5231,0,4712,26683,23409,3274
1/5/2016 1:00,35516,5064,0,4712,25740,23594,2146
1/5/2016 2:00,35233,5017,0,4712,25504,23648,1856
1/5/2016 3:00,35378,5290,0,4712,25375,24311,1064
1/5/2016 4:00,36009,5239,0,4712,26057,25230,827
1/5/2016 5:00,37671,5915,0,4712,27044,27300,-256
1/5/2016 6:00,41037,6325,0,4712,30000,31331,-1331
1/5/2016 7:00,45622,7153,0,4712,33756,32221,1535
1/5/2016 8:00,46975,7206,31,4712,35026,31427,3599
1/5/2016 9:00,45788,6225,197,4712,34653,31066,3587
1/5/2016 10:00,44580,5381,253,4712,34234,29906,4328
1/5/2016 11:00,43177,5426,272,4712,32767,28599,4168
1/5/2016 12:00,41477,5071,328,4712,31367,27204,4163
1/5/2016 13:00,39889,4959,329,4712,29889,25827,4062
1/5/2016 14:00,38763,5182,300,4712,28570,24855,3715
1/5/2016 15:00,37668,5191,279,4712,27486,24530,2956
1/5/2016 16:00,37163,5177,236,4712,27038,24928,2110
1/5/2016 17:00,37898,5085,170,4712,27931,27158,773
1/5/2016 18:00,40373,5607,0,4712,30055,29253,802
1/5/2016 19:00,42857,6346,0,4712,31798,28755,3043
1/5/2016 20:00,42912,7147,0,4712,31052,27695,3357
1/5/2016 21:00,42428,7624,0,4712,30092,25737,4355
1/5/2016 22:00,40907,7634,0,4712,28561,23835,4726
1/5/2016 23:00,38344,7975,0,4712,25657,21629,4028
1/6/2016 0:00,35798,7549,0,4712,23537,20330,3207
1/6/2016 1:00,34194,7807,0,4712,21675,19355,2320
1/6/2016 2:00,33414,8330,0,4712,20372,18756,1616
1/6/2016 3:00,33050,8303,0,4712,20035,19025,1010
1/6/2016 4:00,33073,7680,0,4712,20681,20126,555
1/6/2016 5:00,34042,8031,0,4712,21299,22096,-797
1/6/2016 6:00,36671,8136,0,4712,23822,25247,-1425
1/6/2016 7:00,40660,7491,0,4712,28457,27227,1230
1/6/2016 8:00,41850,7131,53,4712,29954,26507,3447
1/6/2016 9:00,40990,6675,293,4712,29311,27193,2118
1/6/2016 10:00,40826,5524,292,4712,30297,27831,2466
1/6/2016 11:00,40689,4905,309,4712,30762,27746,3016
1/6/2016 12:00,40303,5355,320,4712,29916,26600,3316
1/6/2016 13:00,39685,6067,306,4712,28600,25872,2728
1/6/2016 14:00,39162,5571,299,4712,28580,25888,2692
1/6/2016 15:00,38572,5202,271,4712,28387,25922,2465
1/6/2016 16:00,38387,4778,238,4712,28660,26972,1688
1/6/2016 17:00,38905,4180,167,4712,29845,29413,432
1/6/2016 18:00,40572,3127,0,4712,32733,30467,2266
1/6/2016 19:00,41745,3153,0,4712,33880,30334,3546
1/6/2016 20:00,41284,3701,0,4712,32872,29070,3802
1/6/2016 21:00,40396,4694,0,4712,30990,26012,4978
1/6/2016 22:00,38603,5247,0,4712,28645,23417,5228
1/6/2016 23:00,35901,5413,0,4712,25775,20529,5246
1/7/2016 0:00,33185,5408,0,4712,23065,18525,4540
1/7/2016 1:00,31352,5676,0,4712,20964,17878,3086
1/7/2016 2:00,30404,5842,0,4712,19849,17345,2504
1/7/2016 3:00,29970,6162,0,4712,19096,16750,2346
1/7/2016 4:00,29964,7247,0,4712,18006,16992,1014
1/7/2016 5:00,30746,7327,0,4712,18706,18808,-102
1/7/2016 6:00,33094,7322,0,4712,21060,22079,-1019
1/7/2016 7:00,36880,7206,0,4712,24962,23100,1862
1/7/2016 8:00,38111,7297,26,4712,26076,22645,3431
1/7/2016 9:00,37338,6744,138,4712,25744,22838,2906
1/7/2016 10:00,37089,6563,170,4712,25643,21852,3791
1/7/2016 11:00,36698,7543,164,4712,24278,20577,3701
1/7/2016 12:00,35944,8724,187,4712,22321,19170,3151
1/7/2016 13:00,35153,9368,210,4712,20862,18038,2824
1/7/2016 14:00,34726,9624,175,4712,20214,17523,2691
1/7/2016 15:00,34313,9611,187,4712,19803,17677,2126
1/7/2016 16:00,34003,8890,163,4712,20238,18791,1447
1/7/2016 17:00,33975,7355,101,4712,21807,20970,837
1/7/2016 18:00,34799,5792,0,4712,24295,23390,905
1/7/2016 19:00,36982,5751,0,4712,26519,23548,2971
1/7/2016 20:00,36977,5635,0,4712,26630,23495,3135
1/7/2016 21:00,36595,4867,0,4712,27016,23334,3682
1/7/2016 22:00,35352,3713,0,4712,26928,22220,4708
1/7/2016 23:00,33196,3189,0,4712,25295,21146,4149
1/8/2016 0:00,31065,2470,0,4712,23882,19984,3898
1/8/2016 1:00,29655,2602,0,4712,22341,19290,3051
1/8/2016 2:00,29078,2631,0,4712,21735,19087,2648
1/8/2016 3:00,28970,2590,0,4712,21668,19355,2313
1/8/2016 4:00,29216,2650,0,4712,21854,19977,1877
1/8/2016 5:00,30303,2819,0,4712,22772,22602,170
1/8/2016 6:00,32993,2459,0,4712,25822,25707,115
1/8/2016 7:00,37096,2709,0,4712,29675,27088,2587
1/8/2016 8:00,38732,2673,14,4712,31333,26781,4552
1/8/2016 9:00,37990,2064,168,4712,31045,26975,4070
1/8/2016 10:00,37598,1426,215,4712,31245,26952,4293
1/8/2016 11:00,37000,1189,237,4712,30863,26307,4556
1/8/2016 12:00,36453,1328,241,4712,30172,25840,4332
1/8/2016 13:00,35885,2270,212,4712,28692,24589,4103
1/8/2016 14:00,35407,2510,194,4712,27991,23819,4172
1/8/2016 15:00,34765,3083,159,4712,26811,23313,3498
1/8/2016 16:00,34346,3530,124,4712,25980,22923,3057
1/8/2016 17:00,34445,4103,55,4712,25575,23515,2060
1/8/2016 18:00,35547,4137,0,4712,26698,24784,1914
1/8/2016 19:00,36945,3647,0,4712,28586,24645,3941
1/8/2016 20:00,36599,3727,0,4712,28161,24105,4056
1/8/2016 21:00,36192,4590,0,4712,26890,23539,3351
1/8/2016 22:00,35507,4471,0,4712,26324,22461,3863
1/8/2016 23:00,34122,3898,0,4712,25512,20770,4742
1/9/2016 0:00,32472,4487,0,4712,23273,19481,3792
1/9/2016 1:00,31051,5416,0,4712,20923,18173,2750
1/9/2016 2:00,30159,6404,0,4712,19043,16375,2668
1/9/2016 3:00,29741,7814,0,4712,17214,15804,1410
1/9/2016 4:00,29866,7838,0,4712,17316,15878,1438
1/9/2016 5:00,30362,8642,0,4712,17009,16901,108
1/9/2016 6:00,31646,8366,0,4712,18568,17963,605
1/9/2016 7:00,33545,8555,0,4712,20278,19588,690
1/9/2016 8:00,35594,8407,13,4712,22462,20888,1574
1/9/2016 9:00,37357,8142,74,4712,24429,21842,2587
1/9/2016 10:00,38710,8562,86,4712,25350,22498,2852
1/9/2016 11:00,39208,8128,115,4712,26253,22616,3637
1/9/2016 12:00,39258,8178,127,4712,26240,22846,3394
1/9/2016 13:00,38965,7887,121,4712,26245,23223,3022
1/9/2016 14:00,38539,7353,122,4712,26352,23642,2710
1/9/2016 15:00,38171,7066,99,4712,26294,24010,2284
1/9/2016 16:00,38194,6711,118,4712,26653,24714,1939
1/9/2016 17:00,38773,6219,43,4712,27799,26531,1268
1/9/2016 18:00,40598,5235,0,4712,30651,29217,1434
1/9/2016 19:00,42727,4857,0,4712,33158,29692,3466
1/9/2016 20:00,42916,4666,0,4712,33538,29954,3584
1/9/2016 21:00,42845,4004,0,4712,34129,29999,4130
1/9/2016 22:00,42378,3868,0,4712,33798,29426,4372
1/9/2016 23:00,41275,3439,0,4712,33124,29075,4049
1/10/2016 0:00,40130,2599,0,4712,32818,28743,4075
1/10/2016 1:00,39105,2241,0,4712,32152,28543,3609
1/10/2016 2:00,38610,2098,0,4712,31801,28451,3350
1/10/2016 3:00,38524,2144,0,4712,31668,28758,2910
1/10/2016 4:00,38835,2066,0,4712,32057,29304,2753
1/10/2016 5:00,39576,2235,0,4712,32629,30352,2277
1/10/2016 6:00,40936,2226,0,4712,33998,31735,2263
1/10/2016 7:00,42708,2386,0,4712,35611,32997,2614
1/10/2016 8:00,44327,2606,0,4712,37010,33984,3026
1/10/2016 9:00,45077,1868,3,4712,38493,33784,4709
1/10/2016 10:00,44536,1698,14,4712,38113,32529,5584
1/10/2016 11:00,42976,1226,50,4712,36988,31117,5871
1/10/2016 12:00,41173,1128,48,4712,35285,29566,5719
1/10/2016 13:00,39482,1030,47,4712,33693,28216,5477
1/10/2016 14:00,37882,1057,53,4712,32060,27297,4763
1/10/2016 15:00,36615,1150,82,4712,30671,26831,3840
1/10/2016 16:00,36027,1304,88,4712,29922,27140,2782
1/10/2016 17:00,36477,1363,111,4712,30291,29377,914
1/10/2016 18:00,39264,1559,0,4712,32993,32093,900
1/10/2016 19:00,42846,2270,0,4712,35864,32437,3427
1/10/2016 20:00,43920,2944,0,4712,36264,32134,4130
1/10/2016 21:00,44126,3515,0,4712,35899,31131,4768
1/10/2016 22:00,43382,3803,0,4712,34867,29190,5677
1/10/2016 23:00,41481,3907,0,4712,32862,27753,5109
1/11/2016 0:00,39509,3938,0,4712,30859,27286,3573
1/11/2016 1:00,38425,3376,0,4712,30337,27179,3158
1/11/2016 2:00,38077,3359,0,4712,30006,27265,2741
1/11/2016 3:00,38217,3451,0,4712,30053,27715,2338
1/11/2016 4:00,38835,3778,0,4712,30345,28832,1513
1/11/2016 5:00,40187,3532,0,4712,31943,31495,448
1/11/2016 6:00,43358,3200,0,4712,35446,36110,-664
1/11/2016 7:00,47970,3322,0,4712,39936,37108,2828
1/11/2016 8:00,49250,3620,0,4712,40917,35746,5171
1/11/2016 9:00,47693,2683,170,4712,40129,35103,5026
1/11/2016 10:00,46157,2081,217,4712,39147,33768,5379
1/11/2016 11:00,44625,1794,217,4712,37902,32944,4958
1/11/2016 12:00,43109,1101,234,4712,37061,31847,5214
1/11/2016 13:00,41463,727,251,4712,35772,30766,5006
1/11/2016 14:00,39914,615,255,4712,34333,29685,4648
1/11/2016 15:00,38499,607,226,4712,32954,28966,3988
1/11/2016 16:00,37655,692,236,4712,32016,29112,2904
1/11/2016 17:00,37924,715,179,4712,32318,30931,1387
1/11/2016 18:00,40025,669,0,4712,34643,34088,555
1/11/2016 19:00,43394,902,0,4712,37780,34604,3176
1/11/2016 20:00,44020,1009,0,4712,38299,34287,4012
1/11/2016 21:00,43848,1228,0,4712,37908,32922,4986
1/11/2016 22:00,42721,1632,0,4712,36376,30666,5710
1/11/2016 23:00,40442,1771,0,4712,33959,28941,5018
1/12/2016 0:00,38535,1969,0,4712,31854,27783,4071
1/12/2016 1:00,37292,2035,0,4712,30545,27305,3240
1/12/2016 2:00,36992,2318,0,4712,29962,27038,2924
1/12/2016 3:00,37172,2950,0,4712,29510,27121,2389
1/12/2016 4:00,37717,3439,0,4712,29566,28172,1394
1/12/2016 5:00,39148,3129,0,4712,31307,31203,104
1/12/2016 6:00,42371,2703,0,4712,34956,35686,-730
1/12/2016 7:00,46957,2385,0,4712,39860,36903,2957
1/12/2016 8:00,48089,2374,3,4712,41000,35316,5684
1/12/2016 9:00,45703,2086,55,4712,38850,33073,5777
1/12/2016 10:00,43061,1214,72,4712,37062,31599,5463
1/12/2016 11:00,40757,626,80,4712,35339,29769,5570
1/12/2016 12:00,38644,727,78,4712,33127,27914,5213
1/12/2016 13:00,36884,704,77,4712,31391,27182,4209
1/12/2016 14:00,35737,735,84,4712,30206,26426,3780
1/12/2016 15:00,34803,871,90,4712,29131,25890,3241
1/12/2016 16:00,34280,894,74,4712,28600,25783,2817
1/12/2016 17:00,34257,1072,47,4712,28426,26506,1920
1/12/2016 18:00,35531,1586,1,4712,29232,28233,999
1/12/2016 19:00,38449,2625,0,4712,31112,27819,3293
1/12/2016 20:00,39037,3939,0,4712,30385,26999,3386
1/12/2016 21:00,39176,4515,0,4712,29949,25499,4450
1/12/2016 22:00,38344,5505,0,4712,28127,23037,5090
1/12/2016 23:00,36480,6654,0,4712,25114,20689,4425
1/13/2016 0:00,34584,7358,0,4712,22514,18737,3777
1/13/2016 1:00,33639,8615,0,4712,20312,17883,2429
1/13/2016 2:00,33454,9395,0,4712,19347,17961,1386
1/13/2016 3:00,33585,9002,0,4712,19871,19271,600
1/13/2016 4:00,34304,8363,0,4712,21229,21069,160
1/13/2016 5:00,35888,7999,0,4712,23177,24210,-1033
1/13/2016 6:00,39242,8001,0,4712,26529,27698,-1169
1/13/2016 7:00,43909,9097,0,4712,30101,28863,1238
1/13/2016 8:00,45255,8329,0,4712,32213,27839,4374
1/13/2016 9:00,43191,6831,9,4712,31639,28054,3585
1/13/2016 10:00,40922,3799,30,4712,32381,28396,3985
1/13/2016 11:00,38971,3120,51,4712,31087,27218,3869
1/13/2016 12:00,37264,2836,62,4712,29653,25899,3754
1/13/2016 13:00,35839,2733,83,4712,28311,25033,3278
1/13/2016 14:00,34946,2481,78,4712,27675,24532,3143
1/13/2016 15:00,34265,2437,86,4712,27030,23873,3157
1/13/2016 16:00,33788,2557,71,4712,26448,23882,2566
1/13/2016 17:00,33977,2811,47,4712,26408,24780,1628
1/13/2016 18:00,35167,3241,0,4712,27214,26188,1026
1/13/2016 19:00,37677,5053,0,4712,27912,24952,2960
1/13/2016 20:00,38035,6607,0,4712,26716,23426,3290
1/13/2016 21:00,37905,7726,0,4712,25467,21909,3558
1/13/2016 22:00,36897,8251,0,4712,23934,19708,4226
1/13/2016 23:00,34852,8722,0,4712,21418,17113,4305
1/14/2016 0:00,32768,9566,0,4712,18490,15543,2947
1/14/2016 1:00,31499,10038,0,4712,16749,14738,2011
1/14/2016 2:00,30897,10147,0,4712,16038,14895,1143
1/14/2016 3:00,30846,10085,0,4712,16049,14952,1097
1/14/2016 4:00,31114,9964,0,4712,16438,16210,228
1/14/2016 5:00,32171,9664,0,4712,17795,18762,-967
1/14/2016 6:00,34978,9083,0,4712,21182,22484,-1302
1/14/2016 7:00,39136,8520,0,4712,25904,24258,1646
1/14/2016 8:00,40348,7982,0,4712,27654,23459,4195
1/14/2016 9:00,39073,7541,2,4712,26818,23032,3786
1/14/2016 10:00,38051,6749,16,4712,26574,22708,3866
1/14/2016 11:00,37156,7272,46,4712,25125,21052,4073
1/14/2016 12:00,36288,8496,56,4712,23025,19810,3215
1/14/2016 13:00,35512,8635,61,4712,22105,18962,3143
1/14/2016 14:00,35058,8591,58,4712,21697,18758,2939
1/14/2016 15:00,34451,8065,58,4712,21616,18759,2857
1/14/2016 16:00,34142,7466,52,4712,21913,19004,2909
1/14/2016 17:00,34130,7470,35,4712,21913,19832,2081
1/14/2016 18:00,34879,8372,1,4712,21793,20060,1733
1/14/2016 19:00,37097,10332,0,4712,22052,19703,2349
1/14/2016 20:00,37221,10000,0,4712,22509,19297,3212
1/14/2016 21:00,36630,10360,0,4712,21557,17922,3635
1/14/2016 22:00,35219,10574,0,4712,19932,15393,4539
1/14/2016 23:00,33052,10806,0,4712,17533,13823,3710
1/15/2016 0:00,30714,9793,0,4712,16209,13336,2873
1/15/2016 1:00,29194,9529,0,4712,14952,13048,1904
1/15/2016 2:00,28564,9275,0,4712,14577,13388,1189
1/15/2016 3:00,28344,8216,0,4712,15416,14824,592
1/15/2016 4:00,28671,6890,0,4712,17070,16748,322
1/15/2016 5:00,29727,6025,0,4712,18989,19794,-805
1/15/2016 6:00,32477,5346,0,4712,22419,23966,-1547
1/15/2016 7:00,36897,4992,0,4712,27193,26009,1184
1/15/2016 8:00,38639,4097,39,4712,29791,26292,3499
1/15/2016 9:00,37950,2684,234,4712,30320,27236,3084
1/15/2016 10:00,37274,735,293,4712,31534,27527,4007
1/15/2016 11:00,36584,563,306,4712,31003,26864,4139
1/15/2016 12:00,35739,633,304,4712,30090,26013,4077
1/15/2016 13:00,34892,894,293,4712,28993,25481,3512
1/15/2016 14:00,34448,1318,246,4712,28172,25199,2973
1/15/2016 15:00,34049,948,207,4712,28182,25241,2941
1/15/2016 16:00,33760,824,229,4712,27995,25134,2861
1/15/2016 17:00,33634,730,176,4712,28016,25376,2640
1/15/2016 18:00,34004,1126,1,4712,28165,26105,2060
1/15/2016 19:00,35709,1848,0,4712,29148,25188,3960
1/15/2016 20:00,35605,3319,0,4712,27575,24286,3289
1/15/2016 21:00,35219,4112,0,4712,26395,22581,3814
1/15/2016 22:00,34530,5794,0,4712,24025,19926,4099
1/15/2016 23:00,33477,6614,0,4712,22152,18295,3857
1/16/2016 0:00,32105,6585,0,4712,20808,17597,3211
1/16/2016 1:00,31026,7152,0,4712,19162,16666,2496
1/16/2016 2:00,30456,7287,0,4712,18457,17100,1357
1/16/2016 3:00,30296,6185,0,4712,19399,17606,1793
1/16/2016 4:00,30418,6392,0,4712,19314,17766,1548
1/16/2016 5:00,30935,6959,0,4712,19264,18692,572
1/16/2016 6:00,32143,5900,0,4712,21532,20379,1153
1/16/2016 7:00,33815,5872,0,4712,23231,21165,2066
1/16/2016 8:00,35515,7170,20,4712,23613,21815,1798
1/16/2016 9:00,37126,7253,221,4712,24940,22061,2879
1/16/2016 10:00,38347,8599,301,4712,24735,21641,3094
1/16/2016 11:00,38662,9051,343,4712,24555,21472,3083
1/16/2016 12:00,38395,8382,347,4712,24954,21740,3214
1/16/2016 13:00,37710,6938,351,4712,25709,22109,3600
1/16/2016 14:00,37110,5980,302,4712,26116,22832,3284
1/16/2016 15:00,36872,4735,269,4712,27155,24476,2679
1/16/2016 16:00,36967,3899,176,4712,28180,25524,2656
1/16/2016 17:00,37082,3261,137,4712,28972,26877,2095
1/16/2016 18:00,38094,2899,9,4712,30474,29068,1406
1/16/2016 19:00,40335,2683,0,4712,32940,29827,3113
1/16/2016 20:00,40639,2391,0,4712,33536,29351,4185
1/16/2016 21:00,40500,2715,0,4712,33074,28451,4623
1/16/2016 22:00,39999,3876,0,4712,31411,26690,4721
1/16/2016 23:00,38982,4439,0,4712,29831,25040,4791
1/17/2016 0:00,37838,5349,0,4712,27777,23797,3980
1/17/2016 1:00,36873,5932,0,4712,26228,23394,2834
1/17/2016 2:00,36501,5950,0,4712,25839,23047,2792
1/17/2016 3:00,36484,6828,0,4712,24944,22595,2349
1/17/2016 4:00,36830,7479,0,4712,24639,22512,2127
1/17/2016 5:00,37525,7594,0,4712,25219,23537,1682
1/17/2016 6:00,38785,7513,0,4712,26560,24585,1975
1/17/2016 7:00,40558,8248,0,4712,27598,26136,1462
1/17/2016 8:00,42177,7955,41,4712,29468,27254,2214
1/17/2016 9:00,42734,6915,211,4712,30896,27303,3593
1/17/2016 10:00,41607,5252,207,4712,31436,26376,5060
1/17/2016 11:00,39515,5013,277,4712,29512,24478,5034
1/17/2016 12:00,37376,5522,352,4712,26791,22414,4377
1/17/2016 13:00,35589,5077,363,4712,25437,21880,3557
1/17/2016 14:00,34050,4119,273,4712,24947,21651,3296
1/17/2016 15:00,32960,3512,244,4712,24493,21469,3024
1/17/2016 16:00,32450,3329,197,4712,24212,22010,2202
1/17/2016 17:00,32686,3183,158,4712,24633,23491,1142
1/17/2016 18:00,34394,3913,0,4712,25769,25409,360
1/17/2016 19:00,37438,4624,0,4712,28103,25496,2607
1/17/2016 20:00,38416,5965,0,4712,27739,24027,3712
1/17/2016 21:00,38568,7901,0,4712,25956,23008,2948
1/17/2016 22:00,38376,8083,0,4712,25581,22334,3247
1/17/2016 23:00,37277,7160,0,4712,25405,22652,2753
1/18/2016 0:00,36041,5284,0,4712,26045,23811,2234
1/18/2016 1:00,35452,3799,0,4712,26941,24786,2155
1/18/2016 2:00,35404,2479,0,4712,28212,25824,2388
1/18/2016 3:00,35844,2742,0,4712,28390,26135,2255
1/18/2016 4:00,36770,3167,0,4712,28891,27859,1032
1/18/2016 5:00,38388,2626,0,4712,31049,31164,-115
1/18/2016 6:00,41164,1282,0,4712,35170,34374,796
1/18/2016 7:00,44645,772,0,4712,39160,36366,2794
1/18/2016 8:00,46499,1071,28,4712,40689,36473,4216
1/18/2016 9:00,46123,429,258,4712,40724,35889,4835
1/18/2016 10:00,44975,171,322,4712,39771,34552,5219
1/18/2016 11:00,43312,131,348,4712,38121,32833,5288
1/18/2016 12:00,41485,233,404,4712,36136,31097,5039
1/18/2016 13:00,39570,492,430,4712,33937,29548,4389
1/18/2016 14:00,38031,941,393,4712,31986,28075,3911
1/18/2016 15:00,36717,1227,358,4712,30419,26903,3516
1/18/2016 16:00,35895,1726,294,4712,29163,26379,2784
1/18/2016 17:00,35818,2119,204,4712,28784,26946,1838
1/18/2016 18:00,37263,3503,19,4712,29029,27890,1139
1/18/2016 19:00,40468,6082,0,4712,29674,26479,3195
1/18/2016 20:00,41258,8135,0,4712,28411,24357,4054
1/18/2016 21:00,41290,10441,0,4712,26137,21778,4359
1/18/2016 22:00,40379,12094,0,4712,23572,18888,4684
1/18/2016 23:00,38379,12486,0,4712,21181,17539,3642
1/19/2016 0:00,36194,12159,0,4712,19323,16132,3191
1/19/2016 1:00,34778,12388,0,4712,17678,15823,1855
1/19/2016 2:00,34310,12445,0,4712,17153,15817,1336
1/19/2016 3:00,34279,12319,0,4712,17248,16086,1162
1/19/2016 4:00,34766,12488,0,4712,17565,17181,384
1/19/2016 5:00,35944,12318,0,4712,18914,19898,-984
1/19/2016 6:00,38928,11920,0,4712,22296,22692,-396
1/19/2016 7:00,43076,12271,0,4712,26092,23472,2620
1/19/2016 8:00,43817,12109,64,4712,26932,22713,4219
1/19/2016 9:00,42003,10612,313,4712,26367,22947,3420
1/19/2016 10:00,40603,9675,323,4712,25894,22159,3735
1/19/2016 11:00,39135,8821,355,4712,25247,21750,3497
1/19/2016 12:00,37768,7841,386,4712,24830,21607,3223
1/19/2016 13:00,36676,7089,404,4712,24471,21098,3373
1/19/2016 14:00,35760,7023,367,4712,23658,20429,3229
1/19/2016 15:00,35002,6721,346,4712,23223,20218,3005
1/19/2016 16:00,34552,6634,297,4712,22908,19948,2960
1/19/2016 17:00,34382,6671,228,4712,22771,20708,2063
1/19/2016 18:00,35198,7577,10,4712,22898,21741,1157
1/19/2016 19:00,37557,8141,0,4712,24704,22382,2322
1/19/2016 20:00,37840,7083,0,4712,26045,23072,2973
1/19/2016 21:00,37582,6208,0,4712,26662,22851,3811
1/19/2016 22:00,36543,5959,0,4712,25873,21370,4503
1/19/2016 23:00,34529,5525,0,4712,24292,20073,4219
1/20/2016 0:00,32568,5059,0,4712,22797,19809,2988
1/20/2016 1:00,31539,4155,0,4712,22672,19967,2705
1/20/2016 2:00,31201,3403,0,4712,23086,21013,2073
1/20/2016 3:00,31411,2958,0,4712,23741,21949,1792
1/20/2016 4:00,31926,2465,0,4712,24749,23465,1284
1/20/2016 5:00,33320,2372,0,4712,26236,26060,176
1/20/2016 6:00,36271,2672,0,4712,28887,29865,-978
1/20/2016 7:00,40838,3057,0,4712,33068,30589,2479
1/20/2016 8:00,42114,3993,28,4712,33381,29886,3495
1/20/2016 9:00,41208,3699,256,4712,32541,29436,3105
1/20/2016 10:00,40861,3638,315,4712,32196,28145,4051
1/20/2016 11:00,40071,4783,380,4712,30196,26535,3661
1/20/2016 12:00,39054,4011,384,4712,29947,25982,3965
1/20/2016 13:00,37908,3981,408,4712,28806,24649,4157
1/20/2016 14:00,36981,4604,380,4712,27285,23533,3752
1/20/2016 15:00,36381,4775,325,4712,26569,23145,3424
1/20/2016 16:00,36164,5156,311,4712,25986,23717,2269
1/20/2016 17:00,36701,4204,239,4712,27545,25935,1610
1/20/2016 18:00,38115,4304,22,4712,29077,26844,2233
1/20/2016 19:00,40323,5675,0,4712,29935,25621,4314
1/20/2016 20:00,40314,7437,0,4712,28165,23437,4728
1/20/2016 21:00,39610,8420,0,4712,26477,21522,4955
1/20/2016 22:00,37889,8612,0,4712,24565,19636,4929
1/20/2016 23:00,35184,7685,0,4712,22787,17946,4841
1/21/2016 0:00,32526,6868,0,4712,20946,16976,3970
1/21/2016 1:00,30980,7048,0,4712,19220,16302,2918
1/21/2016 2:00,30134,6676,0,4712,18746,16441,2305
1/21/2016 3:00,29639,5983,0,4712,18944,16508,2436
1/21/2016 4:00,29650,5961,0,4712,18977,16918,2059
1/21/2016 5:00,30338,6471,0,4712,19155,18521,634
1/21/2016 6:00,32779,7772,0,4712,20295,20025,270
1/21/2016 7:00,36896,10149,0,4712,22036,20391,1645
1/21/2016 8:00,38289,10738,0,4712,22839,20012,2827
1/21/2016 9:00,37802,10403,11,4712,22676,19590,3086
1/21/2016 10:00,38164,11843,61,4712,21547,18764,2783
1/21/2016 11:00,38730,12909,89,4712,21019,18736,2283
1/21/2016 12:00,38988,12829,93,4712,21354,18749,2605
1/21/2016 13:00,38858,12609,96,4712,21441,18535,2906
1/21/2016 14:00,38872,13117,75,4712,20969,18077,2892
1/21/2016 15:00,38952,13742,74,4712,20424,17949,2475
1/21/2016 16:00,38918,13655,59,4712,20493,18432,2061
1/21/2016 17:00,39237,13544,19,4712,20963,20220,743
1/21/2016 18:00,40413,12089,1,4712,23611,23901,-290
1/21/2016 19:00,42616,10345,0,4712,27559,25710,1849
1/21/2016 20:00,42978,8521,0,4712,29746,26984,2762
1/21/2016 21:00,42776,6869,0,4712,31195,26953,4242
1/21/2016 22:00,41696,6464,0,4712,30519,25290,5229
1/21/2016 23:00,39672,6790,0,4712,28170,23234,4936
1/22/2016 0:00,37710,7139,0,4712,25858,21685,4173
1/22/2016 1:00,36656,7610,0,4712,24334,21447,2887
1/22/2016 2:00,36287,7983,0,4712,23592,21430,2162
1/22/2016 3:00,36332,7804,0,4712,23816,22514,1302
1/22/2016 4:00,36865,7044,0,4712,25109,23923,1186
1/22/2016 5:00,38285,7210,0,4712,26363,26489,-126
1/22/2016 6:00,41562,7130,0,4712,29720,30454,-734
1/22/2016 7:00,46353,6784,0,4712,34857,32249,2608
1/22/2016 8:00,47919,6592,0,4712,36615,31460,5155
1/22/2016 9:00,46571,5665,3,4712,36191,30787,5404
1/22/2016 10:00,45358,5869,16,4712,34761,29903,4858
1/22/2016 11:00,43987,5087,28,4712,34160,29274,4886
1/22/2016 12:00,42414,3917,37,4712,33748,29025,4723
1/22/2016 13:00,40782,2903,40,4712,33127,28356,4771
1/22/2016 14:00,39447,2583,43,4712,32109,27435,4674
1/22/2016 15:00,38268,2387,37,4712,31132,27000,4132
1/22/2016 16:00,37449,2141,25,4712,30571,27322,3249
1/22/2016 17:00,37560,1678,11,4712,31159,28983,2176
1/22/2016 18:00,38954,1117,0,4712,33125,31692,1433
1/22/2016 19:00,41840,1514,0,4712,35614,31555,4059
1/22/2016 20:00,42484,2419,0,4712,35353,31051,4302
1/22/2016 21:00,42703,3219,0,4712,34773,30366,4407
1/22/2016 22:00,42426,3857,0,4712,33857,28846,5011
1/22/2016 23:00,41443,4380,0,4712,32351,27410,4941
1/23/2016 0:00,40162,4577,0,4712,30872,26374,4498
1/23/2016 1:00,39344,4769,0,4712,29863,25458,4405
1/23/2016 2:00,39118,5636,0,4712,28770,25039,3731
1/23/2016 3:00,39239,6172,0,4712,28355,25249,3106
1/23/2016 4:00,39727,6487,0,4712,28528,25750,2778
1/23/2016 5:00,40515,6544,0,4712,29259,26885,2374
1/23/2016 6:00,42091,6676,0,4712,30702,28851,1851
1/23/2016 7:00,44145,6558,0,4712,32875,30188,2687
1/23/2016 8:00,45932,6678,9,4712,34534,30568,3966
1/23/2016 9:00,46487,6183,68,4712,35524,30545,4979
1/23/2016 10:00,45430,5168,174,4712,35376,28934,6442
1/23/2016 11:00,43290,5323,278,4712,32977,26966,6011
1/23/2016 12:00,40740,4710,315,4712,31002,25103,5899
1/23/2016 13:00,38333,5031,339,4712,28251,22910,5341
1/23/2016 14:00,36158,5600,292,4712,25554,20963,4591
1/23/2016 15:00,34574,6062,314,4712,23486,19736,3750
1/23/2016 16:00,33751,6810,264,4712,21965,19211,2754
1/23/2016 17:00,33637,6860,209,4712,21855,19886,1969
1/23/2016 18:00,34848,8162,37,4712,21937,20425,1512
1/23/2016 19:00,37901,11346,0,4712,21843,19629,2214
1/23/2016 20:00,39007,12415,0,4712,21880,19291,2589
1/23/2016 21:00,39229,12864,0,4712,21653,18934,2719
1/23/2016 22:00,38995,12594,0,4712,21688,18195,3493
1/23/2016 23:00,38244,12855,0,4712,20676,17406,3270
1/24/2016 0:00,37203,12747,0,4712,19744,16946,2798
1/24/2016 1:00,36351,12759,0,4712,18880,16526,2354
1/24/2016 2:00,35949,12792,0,4712,18445,16434,2011
1/24/2016 3:00,35895,12821,0,4712,18362,16616,1746
1/24/2016 4:00,36152,12680,0,4712,18760,17341,1419
1/24/2016 5:00,36680,12404,0,4712,19564,18382,1182
1/24/2016 6:00,37805,12471,0,4712,20622,19489,1133
1/24/2016 7:00,39337,12643,0,4712,21983,20607,1376
1/24/2016 8:00,40651,12594,22,4712,23323,21296,2027
1/24/2016 9:00,41064,11787,194,4712,24371,21074,3297
1/24/2016 10:00,40031,11214,249,4712,23857,19489,4368
1/24/2016 11:00,38169,11210,260,4712,21987,17550,4437
1/24/2016 12:00,36228,11706,287,4712,19522,15668,3854
1/24/2016 13:00,34788,12049,280,4712,17747,14677,3070
1/24/2016 14:00,33707,11951,247,4712,16797,14007,2790
1/24/2016 15:00,32806,11841,221,4712,16032,13705,2327
1/24/2016 16:00,32245,11355,200,4712,15977,14121,1856
1/24/2016 17:00,32185,10662,135,4712,16676,15167,1509
1/24/2016 18:00,33106,10943,8,4712,17443,16662,781
1/24/2016 19:00,35949,12557,0,4712,18680,16390,2290
1/24/2016 20:00,36642,12971,0,4712,18960,15860,3100
1/24/2016 21:00,36076,12929,0,4712,18436,14596,3840
1/24/2016 22:00,34888,13178,0,4712,16998,13125,3873
1/24/2016 23:00,32734,13032,0,4712,14991,12117,2874
1/25/2016 0:00,30492,11915,0,4712,13866,11872,1994
1/25/2016 1:00,28934,11049,0,4712,13173,11768,1405
1/25/2016 2:00,28124,10442,0,4712,12970,11938,1032
1/25/2016 3:00,27734,10153,0,4712,12869,12330,539
1/25/2016 4:00,27888,9644,0,4712,13532,13450,82
1/25/2016 5:00,28783,9216,0,4712,14856,15184,-328
1/25/2016 6:00,31289,9773,0,4712,16804,17707,-903
1/25/2016 7:00,35364,9822,0,4712,20831,19627,1204
1/25/2016 8:00,36626,8649,38,4712,23226,20256,2970
1/25/2016 9:00,35610,5570,199,4712,25129,21978,3151
1/25/2016 10:00,35297,5070,289,4712,25227,21617,3610
1/25/2016 11:00,35068,5148,285,4712,24922,21774,3148
1/25/2016 12:00,34846,4080,287,4712,25766,22591,3175
1/25/2016 13:00,34687,3215,415,4712,26345,23327,3018
1/25/2016 14:00,34589,2351,386,4712,27139,23509,3630
1/25/2016 15:00,34279,2033,332,4712,27202,23731,3471
1/25/2016 16:00,34032,2034,301,4712,26984,23957,3027
1/25/2016 17:00,34044,1883,218,4712,27231,24380,2851
1/25/2016 18:00,34682,2050,19,4712,27902,26122,1780
1/25/2016 19:00,36861,2891,0,4712,29258,25413,3845
1/25/2016 20:00,37248,4433,0,4712,28103,23916,4187
1/25/2016 21:00,36624,5736,0,4712,26176,21761,4415
1/25/2016 22:00,35166,6504,0,4712,23950,18723,5227
1/25/2016 23:00,32885,7771,0,4712,20402,15954,4448
1/26/2016 0:00,30642,8267,0,4712,17663,15090,2573
1/26/2016 1:00,29364,7797,0,4712,16855,15193,1662
1/26/2016 2:00,28785,7387,0,4712,16685,15685,1000
1/26/2016 3:00,28616,6880,0,4712,17024,16156,868
1/26/2016 4:00,28958,7138,0,4712,17108,17118,-10
1/26/2016 5:00,30120,7065,0,4712,18344,19701,-1357
1/26/2016 6:00,33050,6771,0,4712,21568,23517,-1949
1/26/2016 7:00,37642,6839,0,4712,26091,24723,1368
1/26/2016 8:00,39563,6935,31,4712,27886,24284,3602
1/26/2016 9:00,39176,7190,126,4712,27147,24429,2718
1/26/2016 10:00,39284,7305,178,4712,27089,24766,2323
1/26/2016 11:00,39349,6692,229,4712,27717,25137,2580
1/26/2016 12:00,39020,5886,286,4712,28137,25119,3018
1/26/2016 13:00,38667,5726,236,4712,27993,25029,2964
1/26/2016 14:00,38690,5485,182,4712,28311,24988,3323
1/26/2016 15:00,38691,5717,175,4712,28086,25412,2674
1/26/2016 16:00,39038,4958,150,4712,29218,27026,2192
1/26/2016 17:00,40050,4439,116,4712,30782,29263,1519
1/26/2016 18:00,41580,3121,4,4712,33743,31485,2258
1/26/2016 19:00,43561,2902,0,4712,35947,31759,4188
1/26/2016 20:00,43703,2776,0,4712,36215,31300,4915
1/26/2016 21:00,43122,2832,0,4712,35578,29797,5781
1/26/2016 22:00,41546,3040,0,4712,33794,27512,6282
1/26/2016 23:00,38968,3432,0,4712,30824,25685,5139
1/27/2016 0:00,36697,3919,0,4712,28066,24921,3145
1/27/2016 1:00,35507,3814,0,4712,26981,24982,1999
1/27/2016 2:00,35307,3967,0,4712,26627,24942,1685
1/27/2016 3:00,35471,4573,0,4712,26186,25281,905
1/27/2016 4:00,36113,4712,0,4712,26690,26901,-211
1/27/2016 5:00,37635,3861,0,4712,29063,30106,-1043
1/27/2016 6:00,40958,3765,0,4712,32481,33846,-1365
1/27/2016 7:00,45678,3833,0,4712,37133,35105,2028
1/27/2016 8:00,46954,3329,79,4712,38834,34667,4167
1/27/2016 9:00,45423,2807,253,4712,37650,34020,3630
1/27/2016 10:00,43755,1879,337,4712,36827,32983,3844
1/27/2016 11:00,42046,1939,375,4712,35020,31484,3536
1/27/2016 12:00,40332,2026,403,4712,33191,30139,3052
1/27/2016 13:00,38652,2275,416,4712,31249,28958,2291
1/27/2016 14:00,37445,2313,402,4712,30018,27917,2101
1/27/2016 15:00,36405,2678,350,4712,28665,26999,1666
1/27/2016 16:00,35897,2850,296,4712,28039,27161,878
1/27/2016 17:00,36076,2587,218,4712,28559,28894,-335
1/27/2016 18:00,37378,1777,21,4712,30869,31792,-923
1/27/2016 19:00,40586,2166,0,4712,33708,31840,1868
1/27/2016 20:00,41758,3496,0,4712,33551,31012,2539
1/27/2016 21:00,42126,5322,0,4712,32092,28858,3234
1/27/2016 22:00,41403,6505,0,4712,30186,26642,3544
1/27/2016 23:00,39578,6431,0,4712,28434,25544,2890
1/28/2016 0:00,37743,6025,0,4712,27006,24664,2342
1/28/2016 1:00,36883,6766,0,4712,25404,24513,891
1/28/2016 2:00,36762,6451,0,4712,25599,24865,734
1/28/2016 3:00,37030,6664,0,4712,25654,25577,77
1/28/2016 4:00,37772,6354,0,4712,26707,26802,-95
1/28/2016 5:00,39364,6100,0,4712,28552,29564,-1012
1/28/2016 6:00,42752,5778,0,4712,32261,34352,-2091
1/28/2016 7:00,47597,4709,0,4712,38177,36343,1834
1/28/2016 8:00,48601,3731,38,4712,40120,35075,5045
1/28/2016 9:00,45890,2147,259,4712,38771,34020,4751
1/28/2016 10:00,43067,781,337,4712,37236,32423,4813
1/28/2016 11:00,40580,527,389,4712,34951,30640,4311
1/28/2016 12:00,38353,617,397,4712,32627,29116,3511
1/28/2016 13:00,36585,549,383,4712,30941,27812,3129
1/28/2016 14:00,35365,669,402,4712,29582,26980,2602
1/28/2016 15:00,34428,758,347,4712,28612,26575,2037
1/28/2016 16:00,33854,795,287,4712,28060,26503,1557
1/28/2016 17:00,33683,637,212,4712,28122,26906,1216
1/28/2016 18:00,34206,528,69,4712,28897,28667,230
1/28/2016 19:00,36625,1368,0,4712,30544,28288,2256
1/28/2016 20:00,37475,2564,0,4712,30199,27268,2931
1/28/2016 21:00,37496,3795,0,4712,28989,25528,3461
1/28/2016 22:00,36674,5193,0,4712,26769,22628,4141
1/28/2016 23:00,34892,6579,0,4712,23601,20087,3514
1/29/2016 0:00,33023,7426,0,4712,20884,18509,2375
1/29/2016 1:00,32072,8274,0,4712,19086,17757,1329
1/29/2016 2:00,31851,8615,0,4712,18524,17727,797
1/29/2016 3:00,32089,9297,0,4712,18080,18158,-78
1/29/2016 4:00,32769,8948,0,4712,19109,19404,-295
1/29/2016 5:00,34155,9095,0,4712,20348,21914,-1566
1/29/2016 6:00,37314,9590,0,4712,23012,25983,-2971
1/29/2016 7:00,41992,9891,0,4712,27389,26776,613
1/29/2016 8:00,43308,10336,21,4712,28239,24484,3755
1/29/2016 9:00,41266,9578,209,4712,26767,23840,2927
1/29/2016 10:00,39057,7334,169,4712,26843,22243,4600
1/29/2016 11:00,37155,8523,219,4712,23701,19455,4246
1/29/2016 12:00,35729,10447,247,4712,20324,16902,3422
1/29/2016 13:00,34879,11831,238,4712,18098,16050,2048
1/29/2016 14:00,34465,11783,243,4712,17727,15798,1929
1/29/2016 15:00,34032,11923,226,4712,17171,15470,1701
1/29/2016 16:00,33783,12266,211,4712,16593,15257,1336
1/29/2016 17:00,33613,12158,127,4712,16616,15809,807
1/29/2016 18:00,33571,11166,40,4712,17652,17198,454
1/29/2016 19:00,35038,12099,0,4712,18227,17139,1088
1/29/2016 20:00,34967,11396,0,4712,18858,17025,1833
1/29/2016 21:00,34306,10675,0,4712,18919,16932,1987
1/29/2016 22:00,33395,10046,0,4712,18638,16238,2400
1/29/2016 23:00,32004,8945,0,4712,18347,16034,2313
1/30/2016 0:00,30279,7581,0,4712,17985,15691,2294
1/30/2016 1:00,28869,6468,0,4712,17689,15643,2046
1/30/2016 2:00,28130,6243,0,4712,17175,15681,1494
1/30/2016 3:00,27847,5699,0,4712,17436,16049,1387
1/30/2016 4:00,27899,5398,0,4712,17790,16774,1016
1/30/2016 5:00,28444,5758,0,4712,17974,17266,708
1/30/2016 6:00,29716,6763,0,4712,18241,18358,-117
1/30/2016 7:00,31661,7503,0,4712,19447,18964,483
1/30/2016 8:00,33445,7981,20,4712,20732,19566,1166
1/30/2016 9:00,34316,7425,99,4712,22080,20289,1791
1/30/2016 10:00,34191,6087,147,4712,23244,19789,3455
1/30/2016 11:00,33695,7453,132,4712,21398,18209,3189
1/30/2016 12:00,33047,8445,123,4712,19767,16796,2971
1/30/2016 13:00,32426,9591,140,4712,17983,15374,2609
1/30/2016 14:00,31990,10498,136,4712,16643,14345,2298
1/30/2016 15:00,31813,11680,104,4712,15316,13619,1697
1/30/2016 16:00,31774,12173,87,4712,14802,13431,1371
1/30/2016 17:00,31830,12456,48,4712,14615,13971,644
1/30/2016 18:00,32014,12039,0,4712,15263,14672,591
1/30/2016 19:00,33515,13018,0,4712,15785,13831,1954
1/30/2016 20:00,33566,13572,0,4712,15282,13157,2125
1/30/2016 21:00,32940,13636,0,4712,14591,12468,2123
1/30/2016 22:00,32020,13506,0,4712,13803,11564,2239
1/30/2016 23:00,30611,12691,0,4712,13208,11030,2178
1/31/2016 0:00,28890,11221,0,4712,12957,10705,2252
1/31/2016 1:00,27426,10275,0,4712,12439,10492,1947
1/31/2016 2:00,26432,9897,0,4712,11824,10460,1364
1/31/2016 3:00,25881,9834,0,4712,11335,10500,835
1/31/2016 4:00,25616,9572,0,4712,11333,10678,655
1/31/2016 5:00,25631,9312,0,4712,11607,10922,685
1/31/2016 6:00,26081,9014,0,4712,12355,11306,1049
1/31/2016 7:00,26998,9755,0,4712,12531,12110,421
1/31/2016 8:00,27884,9107,0,4712,14064,14113,-49
1/31/2016 9:00,29083,6461,18,4712,17892,16777,1115
1/31/2016 10:00,30253,5093,60,4712,20387,18234,2153
1/31/2016 11:00,30838,4144,95,4712,21888,19186,2702
1/31/2016 12:00,31210,3407,100,4712,22992,20365,2627
1/31/2016 13:00,31673,2554,145,4712,24261,21400,2861
1/31/2016 14:00,32153,1906,135,4712,25400,22165,3235
1/31/2016 15:00,32452,1324,155,4712,26262,22442,3820
1/31/2016 16:00,32692,1265,176,4712,26539,22489,4050
1/31/2016 17:00,32963,1572,132,4712,26547,22824,3723
1/31/2016 18:00,33385,1825,42,4712,26806,23429,3377
1/31/2016 19:00,35072,3631,0,4712,26729,22196,4533
1/31/2016 20:00,35480,5747,0,4712,25021,20749,4272
1/31/2016 21:00,34685,6480,0,4712,23494,19472,4022
1/31/2016 22:00,33363,6216,0,4712,22436,17574,4862
1/31/2016 23:00,31122,6355,0,4712,20055,15293,4762
2/1/2016 0:00,28809,6537,0,4712,17559,13642,3917
2/1/2016 1:00,27234,5877,0,4712,16646,13131,3515
2/1/2016 2:00,26453,5750,0,4712,15992,13084,2908
2/1/2016 3:00,26256,5808,0,4712,15736,12917,2819
2/1/2016 4:00,26513,6709,0,4712,15091,13424,1667
2/1/2016 5:00,27609,6908,0,4712,15989,15745,244
2/1/2016 6:00,30213,7396,0,4712,18105,19351,-1246
2/1/2016 7:00,34571,7425,0,4712,22434,20585,1849
2/1/2016 8:00,36167,7177,1,4712,24278,20598,3680
2/1/2016 9:00,35616,6537,159,4712,24208,21191,3017
2/1/2016 10:00,35535,6111,207,4712,24505,20609,3896
2/1/2016 11:00,35563,7660,232,4712,22959,19250,3709
2/1/2016 12:00,35568,9234,216,4712,21406,18384,3022
2/1/2016 13:00,35603,9773,346,4712,20772,17848,2924
2/1/2016 14:00,35694,10841,353,4712,19789,16839,2950
2/1/2016 15:00,35780,12232,328,4712,18508,15954,2554
2/1/2016 16:00,35942,12368,269,4712,18593,16464,2129
2/1/2016 17:00,35878,11702,211,4712,19253,17301,1952
2/1/2016 18:00,35940,11586,43,4712,19599,18119,1480
2/1/2016 19:00,37759,12682,0,4712,20364,18129,2235
2/1/2016 20:00,38068,12337,0,4712,21020,17355,3665
2/1/2016 21:00,37282,12434,0,4712,20135,15780,4355
2/1/2016 22:00,35615,12579,0,4712,18324,13719,4605
2/1/2016 23:00,33034,11703,0,4712,16619,12684,3935
2/2/2016 0:00,30286,10350,0,4712,15224,11943,3281
2/2/2016 1:00,28270,10202,0,4712,13357,11378,1979
2/2/2016 2:00,27213,9570,0,4712,12930,10994,1936
2/2/2016 3:00,26743,9484,0,4712,12548,10929,1619
2/2/2016 4:00,26640,10017,0,4712,11911,11465,446
2/2/2016 5:00,27398,10642,0,4712,12044,12955,-911
2/2/2016 6:00,29832,10582,0,4712,14539,15735,-1196
2/2/2016 7:00,34056,11476,0,4712,17868,16566,1302
2/2/2016 8:00,35504,11937,73,4712,18781,15993,2788
2/2/2016 9:00,34867,11684,287,4712,18183,15613,2570
2/2/2016 10:00,34808,12807,335,4712,16954,15590,1364
2/2/2016 11:00,34847,12196,309,4712,17631,15657,1974
2/2/2016 12:00,34548,11421,331,4712,18084,16068,2016
2/2/2016 13:00,34321,10248,339,4712,19021,16765,2256
2/2/2016 14:00,34290,9607,328,4712,19642,17146,2496
2/2/2016 15:00,34209,9004,212,4712,20282,17637,2645
2/2/2016 16:00,34143,8399,183,4712,20848,18573,2275
2/2/2016 17:00,34205,7381,141,4712,21971,19683,2288
2/2/2016 18:00,34450,6442,11,4712,23285,21760,1525
2/2/2016 19:00,36381,6437,0,4712,25232,22211,3021
2/2/2016 20:00,36986,6543,0,4712,25731,21427,4304
2/2/2016 21:00,36538,7926,0,4712,23900,20014,3886
2/2/2016 22:00,35308,7802,0,4712,22794,17868,4926
2/2/2016 23:00,33177,8167,0,4712,20298,16489,3809
2/3/2016 0:00,31059,7759,0,4712,18588,16250,2338
2/3/2016 1:00,29782,7549,0,4712,17521,16108,1413
2/3/2016 2:00,29323,7131,0,4712,17480,16475,1005
2/3/2016 3:00,29490,6644,0,4712,18134,16726,1408
2/3/2016 4:00,30035,7249,0,4712,18073,17787,286
2/3/2016 5:00,31552,7723,0,4712,19117,20663,-1546
2/3/2016 6:00,34887,7528,0,4712,22646,24835,-2189
2/3/2016 7:00,40018,7242,0,4712,28064,26676,1388
2/3/2016 8:00,41849,6653,0,4712,30483,26683,3800
2/3/2016 9:00,40839,5583,50,4712,30494,26417,4077
2/3/2016 10:00,40014,4634,83,4712,30585,26525,4060
2/3/2016 11:00,39043,3457,105,4712,30769,26412,4357
2/3/2016 12:00,37897,2805,100,4712,30280,25626,4654
2/3/2016 13:00,36707,2595,136,4712,29264,25149,4115
2/3/2016 14:00,35985,2670,91,4712,28512,24526,3986
2/3/2016 15:00,35103,2850,100,4712,27441,24102,3339
2/3/2016 16:00,34648,2790,71,4712,27076,24554,2522
2/3/2016 17:00,34800,2253,63,4712,27772,25909,1863
2/3/2016 18:00,35930,1595,21,4712,29601,28903,698
2/3/2016 19:00,39135,1646,0,4712,32777,29452,3325
2/3/2016 20:00,40441,2052,0,4712,33677,29360,4317
2/3/2016 21:00,40710,2498,0,4712,33500,28618,4882
2/3/2016 22:00,39948,2631,0,4712,32604,27032,5572
2/3/2016 23:00,38009,2978,0,4712,30319,25222,5097
2/4/2016 0:00,36093,2935,0,4712,28447,24883,3564
2/4/2016 1:00,35209,2424,0,4712,28073,25113,2960
2/4/2016 2:00,35076,2543,0,4712,27822,25177,2645
2/4/2016 3:00,35392,2597,0,4712,28083,25916,2167
2/4/2016 4:00,36171,2520,0,4712,28939,26971,1968
2/4/2016 5:00,37782,2643,0,4712,30427,29814,613
2/4/2016 6:00,41212,2498,0,4712,34002,34419,-417
2/4/2016 7:00,46204,2474,0,4712,39017,35397,3620
2/4/2016 8:00,47397,2431,2,4712,40253,33542,6711
2/4/2016 9:00,45102,1782,183,4712,38425,31461,6964
2/4/2016 10:00,42703,2374,292,4712,35325,28828,6497
2/4/2016 11:00,40561,2917,378,4712,32554,27292,5262
2/4/2016 12:00,38668,2982,353,4712,30621,25774,4847
2/4/2016 13:00,37040,2708,410,4712,29211,25212,3999
2/4/2016 14:00,35850,2149,395,4712,28593,24769,3824
2/4/2016 15:00,34871,1587,368,4712,28204,24628,3576
2/4/2016 16:00,34285,1251,335,4712,27987,24765,3222
2/4/2016 17:00,34232,1030,250,4712,28240,26108,2132
2/4/2016 18:00,35218,824,61,4712,29621,28823,798
2/4/2016 19:00,38449,1254,0,4712,32482,29192,3290
2/4/2016 20:00,40098,2476,0,4712,32910,28643,4267
2/4/2016 21:00,40680,3510,0,4712,32457,27152,5305
2/4/2016 22:00,40148,5317,0,4712,30120,24064,6056
2/4/2016 23:00,38414,7439,0,4712,26263,21304,4959
2/5/2016 0:00,36695,8952,0,4712,23031,19296,3735
2/5/2016 1:00,35856,10295,0,4712,20849,18138,2711
2/5/2016 2:00,35766,11143,0,4712,19911,18283,1628
2/5/2016 3:00,36025,10720,0,4712,20593,19221,1372
2/5/2016 4:00,36625,10242,0,4712,21671,20700,971
2/5/2016 5:00,38168,10893,0,4712,22563,22974,-411
2/5/2016 6:00,41499,11266,0,4712,25521,26652,-1131
2/5/2016 7:00,46391,11417,0,4712,30262,27507,2755
2/5/2016 8:00,47368,11420,0,4712,31236,26500,4736
2/5/2016 9:00,44993,9683,135,4712,30464,24678,5786
2/5/2016 10:00,42615,11177,207,4712,26519,22200,4319
2/5/2016 11:00,40435,11166,239,4712,24317,20807,3510
2/5/2016 12:00,38546,10470,286,4712,23078,20022,3056
2/5/2016 13:00,36871,9128,330,4712,22700,19803,2897
2/5/2016 14:00,35715,8057,329,4712,22617,19637,2980
2/5/2016 15:00,34772,7361,285,4712,22414,19308,3106
2/5/2016 16:00,34149,7365,221,4712,21851,19032,2819
2/5/2016 17:00,34157,8025,178,4712,21242,19501,1741
2/5/2016 18:00,35135,8082,88,4712,22253,22275,-22
2/5/2016 19:00,37632,8583,0,4712,24336,22182,2154
2/5/2016 20:00,38387,9238,0,4712,24437,21713,2724
2/5/2016 21:00,38243,8491,0,4712,25040,21923,3117
2/5/2016 22:00,37559,7760,0,4712,25088,20879,4209
2/5/2016 23:00,36088,8141,0,4712,23235,19052,4183
2/6/2016 0:00,34361,8348,0,4712,21301,17736,3565
2/6/2016 1:00,32995,8322,0,4712,19961,17536,2425
2/6/2016 2:00,32370,7971,0,4712,19687,17396,2291
2/6/2016 3:00,32194,8067,0,4712,19415,17597,1818
2/6/2016 4:00,32462,7989,0,4712,19761,18276,1485
2/6/2016 5:00,33259,7867,0,4712,20680,19803,877
2/6/2016 6:00,34791,7555,0,4712,22524,21910,614
2/6/2016 7:00,36800,7379,0,4712,24709,23427,1282
2/6/2016 8:00,38545,7105,41,4712,26687,24822,1865
2/6/2016 9:00,39348,4777,303,4712,29555,25839,3716
2/6/2016 10:00,39336,4591,376,4712,29658,25712,3946
2/6/2016 11:00,38814,4208,389,4712,29505,25038,4467
2/6/2016 12:00,37666,3846,438,4712,28670,24073,4597
2/6/2016 13:00,36078,3454,461,4712,27451,23144,4307
2/6/2016 14:00,34598,3031,458,4712,26397,22673,3724
2/6/2016 15:00,33521,2870,413,4712,25526,22412,3114
2/6/2016 16:00,32897,2599,375,4712,25210,22362,2848
2/6/2016 17:00,32620,2312,273,4712,25323,23282,2041
2/6/2016 18:00,33284,1957,92,4712,26522,25326,1196
2/6/2016 19:00,35832,2691,0,4712,28429,25198,3231
2/6/2016 20:00,37075,4151,0,4712,28212,24039,4173
2/6/2016 21:00,37399,5855,0,4712,26832,22785,4047
2/6/2016 22:00,37384,7013,0,4712,25658,21298,4360
2/6/2016 23:00,36740,8509,0,4712,23520,19430,4090
2/7/2016 0:00,35818,9763,0,4712,21343,17715,3628
2/7/2016 1:00,35169,10763,0,4712,19694,16687,3007
2/7/2016 2:00,34973,10993,0,4712,19267,16937,2330
2/7/2016 3:00,35148,11006,0,4712,19430,17507,1923
2/7/2016 4:00,35562,10710,0,4712,20139,18589,1550
2/7/2016 5:00,36343,10385,0,4712,21245,19925,1320
2/7/2016 6:00,37688,10377,0,4712,22599,21601,998
2/7/2016 7:00,39478,9883,0,4712,24883,22654,2229
2/7/2016 8:00,40963,9908,116,4712,26227,23562,2665
2/7/2016 9:00,41028,7548,363,4712,28405,24330,4075
2/7/2016 10:00,39337,5883,389,4712,28353,23295,5058
2/7/2016 11:00,37131,5312,438,4712,26668,21860,4808
2/7/2016 12:00,35152,5342,467,4712,24631,20707,3924
2/7/2016 13:00,33743,5160,473,4712,23398,19914,3484
2/7/2016 14:00,32655,4853,464,4712,22626,18983,3643
2/7/2016 15:00,31900,5246,427,4712,21515,17995,3520
2/7/2016 16:00,31500,6288,394,4712,20106,17121,2985
2/7/2016 17:00,31499,7337,297,4712,19153,17094,2059
2/7/2016 18:00,31698,6917,102,4712,19967,18429,1538
2/7/2016 19:00,33277,8098,0,4712,20467,18303,2164
2/7/2016 20:00,34082,8166,0,4712,21203,18391,2812
2/7/2016 21:00,34244,8576,0,4712,20956,17826,3130
2/7/2016 22:00,34200,9386,0,4712,20101,16605,3496
2/7/2016 23:00,33697,10348,0,4712,18636,14612,4024
2/8/2016 0:00,31792,10231,0,4712,16849,13929,2920
2/8/2016 1:00,30676,10077,0,4712,15887,13773,2114
2/8/2016 2:00,30383,10313,0,4712,15358,14222,1136
2/8/2016 3:00,30534,9981,0,4712,15841,14992,849
2/8/2016 4:00,31198,9493,0,4712,16992,16561,431
2/8/2016 5:00,32694,9286,0,4712,18696,19322,-626
2/8/2016 6:00,35954,9213,0,4712,22029,23453,-1424
2/8/2016 7:00,40698,8941,0,4712,27045,25325,1720
2/8/2016 8:00,42181,8152,52,4712,29264,25523,3741
2/8/2016 9:00,40926,6295,200,4712,29719,25254,4465
2/8/2016 10:00,40001,6796,228,4712,28266,24764,3502
2/8/2016 11:00,39256,6704,278,4712,27561,23688,3873
2/8/2016 12:00,38317,7226,344,4712,26035,21981,4054
2/8/2016 13:00,37332,7500,366,4712,24754,21171,3583
2/8/2016 14:00,36520,7326,466,4712,24016,20640,3376
2/8/2016 15:00,35714,6629,433,4712,23940,20902,3038
2/8/2016 16:00,35207,6030,349,4712,24116,21371,2745
2/8/2016 17:00,35283,5366,308,4712,24896,23813,1083
2/8/2016 18:00,36405,3568,135,4712,27990,27572,418
2/8/2016 19:00,39475,2963,0,4712,31800,28804,2996
2/8/2016 20:00,40811,2795,0,4712,33304,28905,4399
2/8/2016 21:00,40697,2666,0,4712,33319,28018,5301
2/8/2016 22:00,39635,2723,0,4712,32200,26081,6119
2/8/2016 23:00,37484,2977,0,4712,29795,24456,5339
2/9/2016 0:00,35519,3071,0,4712,27736,23300,4436
2/9/2016 1:00,34525,3637,0,4712,26176,22367,3809
2/9/2016 2:00,34316,4155,0,4712,25449,22358,3091
2/9/2016 3:00,34569,4612,0,4712,25245,22753,2492
2/9/2016 4:00,35190,5023,0,4712,25454,24073,1381
2/9/2016 5:00,36773,5014,0,4712,27046,26879,167
2/9/2016 6:00,40215,5125,0,4712,30378,29981,397
2/9/2016 7:00,45022,6300,0,4712,34011,30326,3685
2/9/2016 8:00,45878,6307,141,4712,34717,28723,5994
2/9/2016 9:00,43415,4512,374,4712,33817,28858,4959
2/9/2016 10:00,41242,2910,407,4712,33213,26994,6219
2/9/2016 11:00,39345,3647,451,4712,30535,25223,5312
2/9/2016 12:00,37602,3652,479,4712,28759,23983,4776
2/9/2016 13:00,36177,3614,484,4712,27367,23269,4098
2/9/2016 14:00,35197,3259,475,4712,26752,22733,4019
2/9/2016 15:00,34330,3076,435,4712,26106,22378,3728
2/9/2016 16:00,33859,2881,400,4712,25867,22568,3299
2/9/2016 17:00,33816,2390,300,4712,26414,23746,2668
2/9/2016 18:00,34412,1615,113,4712,27972,26483,1489
2/9/2016 19:00,36716,1527,0,4712,30477,27624,2853
2/9/2016 20:00,37832,1391,0,4712,31729,27346,4383
2/9/2016 21:00,37689,2007,0,4712,30969,26142,4827
2/9/2016 22:00,36704,2033,0,4712,29959,24346,5613
2/9/2016 23:00,34639,2476,0,4712,27450,22512,4938
2/10/2016 0:00,32613,2642,0,4712,25259,21665,3594
2/10/2016 1:00,31599,2810,0,4712,24077,21653,2424
2/10/2016 2:00,31455,2887,0,4712,23855,21866,1989
2/10/2016 3:00,31815,2961,0,4712,24142,22506,1636
2/10/2016 4:00,32573,3016,0,4712,24845,23852,993
2/10/2016 5:00,34247,3682,0,4712,25853,25359,494
2/10/2016 6:00,37796,4711,0,4712,28373,28737,-364
2/10/2016 7:00,42750,5301,0,4712,32736,29252,3484
2/10/2016 8:00,43811,5862,149,4712,33089,26645,6444
2/10/2016 9:00,41453,5098,374,4712,31268,25819,5449
2/10/2016 10:00,39291,4168,437,4712,29975,24334,5641
2/10/2016 11:00,37586,5005,446,4712,27423,22664,4759
2/10/2016 12:00,36019,5368,476,4712,25464,21258,4206
2/10/2016 13:00,34980,5853,482,4712,23933,19700,4233
2/10/2016 14:00,34370,7162,475,4712,22020,18686,3334
2/10/2016 15:00,33926,7441,434,4712,21339,18364,2975
2/10/2016 16:00,33689,7357,391,4712,21230,18457,2773
2/10/2016 17:00,33668,7226,283,4712,21447,19285,2162
2/10/2016 18:00,33859,6470,91,4712,22586,19965,2621
2/10/2016 19:00,35447,9298,0,4712,21437,18193,3244
2/10/2016 20:00,36219,11298,0,4712,20209,16892,3317
2/10/2016 21:00,35977,12501,0,4712,18764,15496,3268
2/10/2016 22:00,34895,12602,0,4712,17581,13719,3862
2/10/2016 23:00,32615,12267,0,4712,15636,12337,3299
2/11/2016 0:00,30273,11838,0,4712,13723,11464,2259
2/11/2016 1:00,28919,12028,0,4712,12179,11250,929
2/11/2016 2:00,28337,11922,0,4712,11703,11136,567
2/11/2016 3:00,28206,11986,0,4712,11508,11819,-311
2/11/2016 4:00,28557,10844,0,4712,13001,12934,67
2/11/2016 5:00,29618,10656,0,4712,14251,15995,-1744
2/11/2016 6:00,32350,9592,0,4712,18046,20219,-2173
2/11/2016 7:00,36791,8773,0,4712,23306,22067,1239
2/11/2016 8:00,37859,7390,24,4712,25733,22813,2920
2/11/2016 9:00,36518,4522,225,4712,27058,23350,3708
2/11/2016 10:00,35554,3447,289,4712,27106,23146,3960
2/11/2016 11:00,34894,2700,336,4712,27147,23632,3515
2/11/2016 12:00,34464,2107,348,4712,27298,23756,3542
2/11/2016 13:00,34299,1712,361,4712,27514,24171,3343
2/11/2016 14:00,34483,1751,360,4712,27660,24064,3596
2/11/2016 15:00,34586,1858,404,4712,27611,24013,3598
2/11/2016 16:00,34698,2161,363,4712,27461,24072,3389
2/11/2016 17:00,34791,2313,180,4712,27586,23930,3656
2/11/2016 18:00,34654,2593,45,4712,27304,24705,2599
2/11/2016 19:00,35771,3138,0,4712,27921,24652,3269
2/11/2016 20:00,36260,3753,0,4712,27795,23756,4039
2/11/2016 21:00,35598,4502,0,4712,26384,22970,3414
2/11/2016 22:00,34190,4174,0,4712,25304,20910,4394
2/11/2016 23:00,31891,4311,0,4712,22868,18752,4116
2/12/2016 0:00,29400,4065,0,4712,20623,17500,3123
2/12/2016 1:00,27792,3457,0,4712,19623,17596,2027
2/12/2016 2:00,27042,2714,0,4712,19616,17925,1691
2/12/2016 3:00,26824,2301,0,4712,19811,18433,1378
2/12/2016 4:00,27071,2113,0,4712,20246,19473,773
2/12/2016 5:00,28089,1964,0,4712,21414,22037,-623
2/12/2016 6:00,30770,2181,0,4712,23877,25752,-1875
2/12/2016 7:00,35092,2053,0,4712,28327,26662,1665
2/12/2016 8:00,36545,1925,28,4712,29880,26276,3604
2/12/2016 9:00,35857,1400,94,4712,29651,26227,3424
2/12/2016 10:00,35435,1589,115,4712,29019,25749,3270
2/12/2016 11:00,35089,1285,202,4712,28891,25684,3207
2/12/2016 12:00,34682,1127,299,4712,28544,25416,3128
2/12/2016 13:00,34549,1254,389,4712,28194,25257,2937
2/12/2016 14:00,34814,1516,361,4712,28225,25106,3119
2/12/2016 15:00,35077,1776,418,4712,28171,25008,3163
2/12/2016 16:00,35216,2124,341,4712,28039,24707,3332
2/12/2016 17:00,35257,2644,252,4712,27649,24143,3506
2/12/2016 18:00,34963,3200,149,4712,26902,24007,2895
2/12/2016 19:00,35497,4931,0,4712,25854,22334,3520
2/12/2016 20:00,35467,6688,0,4712,24066,20337,3729
2/12/2016 21:00,34617,7612,0,4712,22293,18664,3629
2/12/2016 22:00,33467,7800,0,4712,20955,17133,3822
2/12/2016 23:00,31824,8237,0,4712,18875,15357,3518
2/13/2016 0:00,29952,7877,0,4712,17364,14302,3062
2/13/2016 1:00,28451,7738,0,4712,16002,13745,2257
2/13/2016 2:00,27578,7387,0,4712,15480,13892,1588
2/13/2016 3:00,27253,6709,0,4712,15832,14474,1358
2/13/2016 4:00,27262,6066,0,4712,16484,15183,1301
2/13/2016 5:00,27678,5653,0,4712,17314,16507,807
2/13/2016 6:00,28859,5370,0,4712,18777,18396,381
2/13/2016 7:00,30648,5285,0,4712,20651,19379,1272
2/13/2016 8:00,32217,5375,79,4712,22051,20538,1513
2/13/2016 9:00,33517,4101,328,4712,24376,21616,2760
2/13/2016 10:00,33915,4473,411,4712,24319,20953,3366
2/13/2016 11:00,33762,5318,446,4712,23286,20173,3113
2/13/2016 12:00,33249,6302,454,4712,21780,18335,3445
2/13/2016 13:00,32667,8163,449,4712,19343,16366,2977
2/13/2016 14:00,32167,8952,454,4712,18048,16044,2004
2/13/2016 15:00,31841,8800,409,4712,17920,15593,2327
2/13/2016 16:00,31661,9602,332,4712,17016,15117,1899
2/13/2016 17:00,31639,10352,241,4712,16334,15103,1231
2/13/2016 18:00,31812,9933,152,4712,17015,16314,701
2/13/2016 19:00,33165,10948,0,4712,17505,14988,2517
2/13/2016 20:00,33719,12853,0,4712,16155,14034,2121
2/13/2016 21:00,33188,13043,0,4712,15433,13433,2000
2/13/2016 22:00,32315,12996,0,4712,14607,12225,2382
2/13/2016 23:00,31001,12645,0,4712,13644,11458,2186
2/14/2016 0:00,29405,11878,0,4712,12815,10783,2032
2/14/2016 1:00,27951,11603,0,4712,11635,10399,1236
2/14/2016 2:00,26949,11030,0,4712,11207,10409,798
2/14/2016 3:00,26380,10956,0,4712,10712,10530,182
2/14/2016 4:00,26093,10676,0,4712,10706,10763,-57
2/14/2016 5:00,26132,10439,0,4712,10981,11086,-105
2/14/2016 6:00,26575,10404,0,4712,11459,11372,87
2/14/2016 7:00,27462,10198,0,4712,12552,12676,-124
2/14/2016 8:00,28265,8606,97,4712,14851,15871,-1020
2/14/2016 9:00,29643,6067,327,4712,18536,17685,851
2/14/2016 10:00,30931,6336,398,4712,19485,18597,888
2/14/2016 11:00,31493,5554,435,4712,20792,19324,1468
2/14/2016 12:00,31578,4560,458,4712,21848,19807,2041
2/14/2016 13:00,31629,4113,437,4712,22367,20329,2038
2/14/2016 14:00,31630,3432,402,4712,23084,20754,2330
2/14/2016 15:00,31460,2847,391,4712,23510,20972,2538
2/14/2016 16:00,31414,2870,309,4712,23523,21164,2359
2/14/2016 17:00,31517,2698,136,4712,23972,21462,2510
2/14/2016 18:00,32021,2635,10,4712,24664,22857,1807
2/14/2016 19:00,33759,2849,0,4712,26197,22964,3233
2/14/2016 20:00,34335,3304,0,4712,26319,22029,4290
2/14/2016 21:00,33615,3691,0,4712,25212,20955,4257
2/14/2016 22:00,32615,4381,0,4712,23521,19326,4195
2/14/2016 23:00,30853,4135,0,4712,22006,18250,3756
2/15/2016 0:00,28762,3371,0,4712,20679,17853,2826
2/15/2016 1:00,27201,2691,0,4712,19797,17509,2288
2/15/2016 2:00,26336,2218,0,4712,19406,17405,2001
2/15/2016 3:00,25953,2406,0,4712,18835,16180,2655
2/15/2016 4:00,25994,4746,0,4712,16537,15117,1420
2/15/2016 5:00,26696,5825,0,4712,16159,15647,512
2/15/2016 6:00,28636,7042,0,4712,16882,17630,-748
2/15/2016 7:00,31693,6667,0,4712,20314,19560,754
2/15/2016 8:00,33120,6282,68,4712,22058,20681,1377
2/15/2016 9:00,33549,3974,168,4712,24694,22963,1731
2/15/2016 10:00,34214,2589,219,4712,26694,23845,2849
2/15/2016 11:00,34791,2604,259,4712,27216,23916,3300
2/15/2016 12:00,35071,2216,273,4712,27870,24584,3286
2/15/2016 13:00,35216,1891,304,4712,28309,24935,3374
2/15/2016 14:00,35547,1997,384,4712,28454,25262,3192
2/15/2016 15:00,35688,2124,338,4712,28514,25127,3387
2/15/2016 16:00,35733,2256,314,4712,28451,24837,3614
2/15/2016 17:00,35629,2367,258,4712,28292,24938,3354
2/15/2016 18:00,35490,2183,94,4712,28501,25814,2687
2/15/2016 19:00,36523,3285,0,4712,28526,24974,3552
2/15/2016 20:00,37011,4874,0,4712,27425,22877,4548
2/15/2016 21:00,36117,6627,0,4712,24778,19456,5322
2/15/2016 22:00,34534,8775,0,4712,21047,15936,5111
2/15/2016 23:00,32157,9236,0,4712,18209,13742,4467
2/16/2016 0:00,29715,9501,0,4712,15502,12339,3163
2/16/2016 1:00,28152,9688,0,4712,13752,11744,2008
2/16/2016 2:00,27528,10073,0,4712,12743,11774,969
2/16/2016 3:00,27322,9531,0,4712,13079,12603,476
2/16/2016 4:00,27530,8406,0,4712,14412,14000,412
2/16/2016 5:00,28522,8563,0,4712,15247,16458,-1211
2/16/2016 6:00,31209,7765,0,4712,18732,20446,-1714
2/16/2016 7:00,35624,7305,0,4712,23607,21518,2089
2/16/2016 8:00,36625,7303,22,4712,24588,20941,3647
2/16/2016 9:00,35658,5734,107,4712,25104,20222,4882
2/16/2016 10:00,35047,7457,195,4712,22682,18770,3912
2/16/2016 11:00,34779,8318,153,4712,21595,18631,2964
2/16/2016 12:00,34640,7846,159,4712,21923,19615,2308
2/16/2016 13:00,34687,6765,240,4712,22971,20934,2037
2/16/2016 14:00,34952,5685,301,4712,24255,22096,2159
2/16/2016 15:00,35171,4790,319,4712,25350,23150,2200
2/16/2016 16:00,35377,3664,261,4712,26740,23996,2744
2/16/2016 17:00,35556,2448,220,4712,28176,24530,3646
2/16/2016 18:00,35456,1831,167,4712,28747,25618,3129
2/16/2016 19:00,36481,2097,0,4712,29672,25311,4361
2/16/2016 20:00,37040,3064,0,4712,29264,24259,5005
2/16/2016 21:00,36187,3779,0,4712,27696,22525,5171
2/16/2016 22:00,34449,4521,0,4712,25216,19889,5327
2/16/2016 23:00,31952,5186,0,4712,22054,17338,4716
2/17/2016 0:00,29434,5508,0,4712,19215,15590,3625
2/17/2016 1:00,27912,5763,0,4712,17438,14816,2622
2/17/2016 2:00,27260,6230,0,4712,16318,14366,1952
2/17/2016 3:00,27126,6690,0,4712,15724,14016,1708
2/17/2016 4:00,27407,7494,0,4712,15201,14365,836
2/17/2016 5:00,28504,8041,0,4712,15752,16329,-577
2/17/2016 6:00,31303,8313,0,4712,18278,19157,-879
2/17/2016 7:00,35819,9257,0,4712,21851,19329,2522
2/17/2016 8:00,36934,9686,155,4712,22381,19206,3175
2/17/2016 9:00,35963,8118,266,4712,22867,18843,4024
2/17/2016 10:00,35338,8986,321,4712,21319,18165,3154
2/17/2016 11:00,35031,9074,351,4712,20893,18281,2612
2/17/2016 12:00,34743,8449,464,4712,21118,18647,2471
2/17/2016 13:00,34570,7757,466,4712,21635,19325,2310
2/17/2016 14:00,34599,6841,466,4712,22580,19990,2590
2/17/2016 15:00,34608,6642,448,4712,22806,19931,2875
2/17/2016 16:00,34769,7071,398,4712,22588,19327,3261
2/17/2016 17:00,34755,7431,290,4712,22323,18891,3432
2/17/2016 18:00,34507,8315,115,4712,21365,18421,2944
2/17/2016 19:00,35825,11116,0,4712,19997,17718,2279
2/17/2016 20:00,36595,11718,0,4712,20166,16118,4048
2/17/2016 21:00,36033,12778,0,4712,18543,14512,4031
2/17/2016 22:00,34515,13067,0,4712,16735,12460,4275
2/17/2016 23:00,32125,12631,0,4712,14782,11402,3380
2/18/2016 0:00,29435,11193,0,4712,13530,10599,2931
2/18/2016 1:00,27829,11647,0,4712,11471,9863,1608
2/18/2016 2:00,27157,11524,0,4712,10921,9780,1141
2/18/2016 3:00,26895,11553,0,4712,10630,9768,862
2/18/2016 4:00,27028,11756,0,4712,10560,10428,132
2/18/2016 5:00,27901,12056,0,4712,11132,12043,-911
2/18/2016 6:00,30457,12628,0,4712,13117,14569,-1452
2/18/2016 7:00,34582,13205,0,4712,16664,14923,1741
2/18/2016 8:00,35551,13183,224,4712,17431,14657,2774
2/18/2016 9:00,35042,12930,386,4712,17014,14739,2275
2/18/2016 10:00,34954,13287,411,4712,16544,14473,2071
2/18/2016 11:00,35044,12968,452,4712,16911,14776,2135
2/18/2016 12:00,34993,13254,472,4712,16555,14727,1828
2/18/2016 13:00,35109,12958,480,4712,16959,15162,1797
2/18/2016 14:00,35506,12859,473,4712,17462,15523,1939
2/18/2016 15:00,35765,12731,451,4712,17871,15337,2534
2/18/2016 16:00,35955,13327,426,4712,17490,15117,2373
2/18/2016 17:00,36099,13415,332,4712,17640,15146,2494
2/18/2016 18:00,35860,13141,147,4712,17859,15968,1891
2/18/2016 19:00,36727,13684,0,4712,18331,16488,1843
2/18/2016 20:00,37278,13619,0,4712,18947,16087,2860
2/18/2016 21:00,36519,13671,0,4712,18136,14971,3165
2/18/2016 22:00,35001,13977,0,4712,16312,12773,3539
2/18/2016 23:00,32575,13908,0,4712,13955,10911,3044
2/19/2016 0:00,29944,12653,0,4712,12579,10300,2279
2/19/2016 1:00,28121,11840,0,4712,11569,10086,1483
2/19/2016 2:00,27048,11273,0,4712,11063,10074,989
2/19/2016 3:00,26428,10548,0,4712,11168,10328,840
2/19/2016 4:00,26232,10167,0,4712,11353,10885,468
2/19/2016 5:00,26690,10125,0,4712,11853,12593,-740
2/19/2016 6:00,28640,10657,0,4712,13271,15579,-2308
2/19/2016 7:00,32261,10162,0,4712,17387,17032,355
2/19/2016 8:00,33397,8179,148,4712,20358,19093,1265
2/19/2016 9:00,33542,5993,349,4712,22488,21476,1012
2/19/2016 10:00,34265,4899,424,4712,24230,23224,1006
2/19/2016 11:00,35057,3985,461,4712,25898,23991,1907
2/19/2016 12:00,35680,3830,475,4712,26663,24652,2011
2/19/2016 13:00,36317,3575,474,4712,27556,25752,1804
2/19/2016 14:00,37267,3598,471,4712,28485,26176,2309
2/19/2016 15:00,37785,3359,443,4712,29271,26302,2969
2/19/2016 16:00,37883,3655,386,4712,29130,25764,3366
2/19/2016 17:00,37848,4359,276,4712,28500,24899,3601
2/19/2016 18:00,37216,4808,192,4712,27505,24275,3230
2/19/2016 19:00,37290,5895,0,4712,26683,23215,3468
2/19/2016 20:00,37215,7812,0,4712,24692,20535,4157
2/19/2016 21:00,36198,9658,0,4712,21828,17527,4301
2/19/2016 22:00,34862,10742,0,4712,19408,15290,4118
2/19/2016 23:00,33013,11146,0,4712,17154,12986,4168
2/20/2016 0:00,30812,11290,0,4712,14810,11737,3073
2/20/2016 1:00,28928,10852,0,4712,13364,11409,1955
2/20/2016 2:00,27667,10252,0,4712,12703,11417,1286
2/20/2016 3:00,26871,9724,0,4712,12435,11459,976
2/20/2016 4:00,26473,9294,0,4712,12467,12070,397
2/20/2016 5:00,26442,8117,0,4712,13613,13012,601
2/20/2016 6:00,26922,7989,0,4712,14220,14296,-76
2/20/2016 7:00,28113,7747,0,4712,15654,15744,-90
2/20/2016 8:00,29206,6491,70,4712,17934,18687,-753
2/20/2016 9:00,30889,4856,197,4712,21125,20816,309
2/20/2016 10:00,32547,4604,252,4712,22980,22093,887
2/20/2016 11:00,33599,4279,274,4712,24334,22815,1519
2/20/2016 12:00,34106,3611,321,4712,25462,23726,1736
2/20/2016 13:00,34497,3339,295,4712,26152,23840,2312
2/20/2016 14:00,34656,3234,374,4712,26335,24011,2324
2/20/2016 15:00,34866,3421,318,4712,26415,23960,2455
2/20/2016 16:00,35034,3707,293,4712,26322,23635,2687
2/20/2016 17:00,34903,4144,218,4712,25829,23220,2609
2/20/2016 18:00,34642,4201,80,4712,25649,23132,2517
2/20/2016 19:00,35437,5854,0,4712,24871,22367,2504
2/20/2016 20:00,35653,6725,0,4712,24216,20650,3566
2/20/2016 21:00,34778,7891,0,4712,22175,18629,3546
2/20/2016 22:00,33594,8229,0,4712,20653,17115,3538
2/20/2016 23:00,31967,7728,0,4712,19527,15469,4058
2/21/2016 0:00,30012,7369,0,4712,17932,13943,3989
2/21/2016 1:00,28237,7269,0,4712,16256,13595,2661
2/21/2016 2:00,26974,6209,0,4712,16053,13896,2157
2/21/2016 3:00,26228,5160,0,4712,16356,14374,1982
2/21/2016 4:00,25749,4235,0,4712,16802,14367,2435
2/21/2016 5:00,25573,4480,0,4712,16381,14496,1885
2/21/2016 6:00,25833,4442,0,4712,16679,15098,1581
2/21/2016 7:00,26591,4226,0,4712,17653,15648,2005
2/21/2016 8:00,27295,5139,34,4712,17410,16087,1323
2/21/2016 9:00,29014,6226,151,4712,17925,16355,1570
2/21/2016 10:00,30798,7548,240,4712,18298,16430,1868
2/21/2016 11:00,32024,7674,277,4712,19362,16948,2414
2/21/2016 12:00,32767,8103,356,4712,19597,17489,2108
2/21/2016 13:00,33083,7309,371,4712,20692,17361,3331
2/21/2016 14:00,33163,8310,422,4712,19719,17165,2554
2/21/2016 15:00,33123,8321,401,4712,19689,17117,2572
2/21/2016 16:00,33149,8402,414,4712,19620,17556,2064
2/21/2016 17:00,33303,7547,317,4712,20728,19397,1331
2/21/2016 18:00,33928,5822,173,4712,23221,22375,846
2/21/2016 19:00,35470,4798,0,4712,25960,23713,2247
2/21/2016 20:00,36017,4436,0,4712,26869,22955,3914
2/21/2016 21:00,35242,4610,0,4712,25920,21701,4219
2/21/2016 22:00,33825,4444,0,4712,24668,19800,4868
2/21/2016 23:00,31531,4523,0,4712,22295,17738,4557
2/22/2016 0:00,29008,3906,0,4712,20391,16585,3806
2/22/2016 1:00,27246,3809,0,4712,18724,15523,3201
2/22/2016 2:00,26230,3882,0,4712,17636,14858,2778
2/22/2016 3:00,25738,3998,0,4712,17028,15220,1808
2/22/2016 4:00,25712,3466,0,4712,17534,15973,1561
2/22/2016 5:00,26392,3580,0,4712,18100,18259,-159
2/22/2016 6:00,28482,3338,0,4712,20431,21707,-1276
2/22/2016 7:00,32302,3826,0,4712,23765,22973,792
2/22/2016 8:00,33696,3440,1,4712,25543,23366,2177
2/22/2016 9:00,33715,2792,127,4712,26083,24011,2072
2/22/2016 10:00,34226,2420,223,4712,26870,24964,1906
2/22/2016 11:00,34585,1480,252,4712,28142,25700,2442
2/22/2016 12:00,34705,1012,266,4712,28715,25949,2766
2/22/2016 13:00,34715,871,213,4712,28918,25638,3280
2/22/2016 14:00,34761,1137,166,4712,28746,25155,3591
2/22/2016 15:00,34701,1801,112,4712,28076,24611,3465
2/22/2016 16:00,34610,2595,84,4712,27219,23913,3306
2/22/2016 17:00,34641,3396,57,4712,26476,23321,3155
2/22/2016 18:00,34870,4284,16,4712,25858,24495,1363
2/22/2016 19:00,36296,4070,0,4712,27514,25018,2496
2/22/2016 20:00,36934,4502,0,4712,27720,23835,3885
2/22/2016 21:00,36163,5575,0,4712,25876,20258,5618
2/22/2016 22:00,34572,6804,0,4712,23056,18129,4927
2/22/2016 23:00,31984,7137,0,4712,20135,15672,4463
2/23/2016 0:00,29345,7231,0,4712,17402,14419,2983
2/23/2016 1:00,27583,7320,0,4712,15552,14057,1495
2/23/2016 2:00,26735,7045,0,4712,14978,13656,1322
2/23/2016 3:00,26284,7470,0,4712,14102,13484,618
2/23/2016 4:00,26313,7412,0,4712,14188,14024,164
2/23/2016 5:00,26974,7134,0,4712,15128,15637,-509
2/23/2016 6:00,29138,7336,0,4712,17090,17798,-708
2/23/2016 7:00,33043,8560,0,4712,19772,17857,1915
2/23/2016 8:00,34558,9785,1,4712,20060,17649,2411
2/23/2016 9:00,34650,9555,16,4712,20367,17464,2903
2/23/2016 10:00,35341,10465,45,4712,20118,17205,2913
2/23/2016 11:00,36049,11701,84,4712,19552,16979,2573
2/23/2016 12:00,36707,12395,105,4712,19495,16942,2553
2/23/2016 13:00,37145,13075,139,4712,19219,16745,2474
2/23/2016 14:00,37396,13418,156,4712,19110,16969,2141
2/23/2016 15:00,37383,12854,164,4712,19652,17445,2207
2/23/2016 16:00,37636,13019,176,4712,19729,17523,2206
2/23/2016 17:00,37930,13283,137,4712,19799,18889,910
2/23/2016 18:00,38570,12062,79,4712,21718,21932,-214
2/23/2016 19:00,40268,10425,0,4712,25131,23638,1493
2/23/2016 20:00,41086,10197,0,4712,26177,23183,2994
2/23/2016 21:00,40677,10909,0,4712,25056,21530,3526
2/23/2016 22:00,39134,11134,0,4712,23288,18620,4668
2/23/2016 23:00,36471,11967,0,4712,19793,15752,4041
2/24/2016 0:00,34004,11754,0,4712,17538,14617,2921
2/24/2016 1:00,32426,11668,0,4712,16047,13929,2118
2/24/2016 2:00,31739,11859,0,4712,15168,14005,1163
2/24/2016 3:00,31512,11503,0,4712,15297,14402,895
2/24/2016 4:00,31693,10904,0,4712,16076,15909,167
2/24/2016 5:00,32856,10619,0,4712,17525,18605,-1080
2/24/2016 6:00,35887,10546,0,4712,20629,23492,-2863
2/24/2016 7:00,40600,10263,0,4712,25625,24756,869
2/24/2016 8:00,41329,8893,56,4712,27668,24879,2789
2/24/2016 9:00,39691,6257,186,4712,28537,25347,3190
2/24/2016 10:00,38655,5231,237,4712,28475,24951,3524
2/24/2016 11:00,37755,5673,272,4712,27098,23533,3565
2/24/2016 12:00,36759,5956,297,4712,25794,22502,3292
2/24/2016 13:00,35732,5307,300,4712,25413,22017,3396
2/24/2016 14:00,34930,5731,282,4712,24204,21267,2937
2/24/2016 15:00,34193,5642,312,4712,23527,20823,2704
2/24/2016 16:00,33627,5353,275,4712,23287,21011,2276
2/24/2016 17:00,33560,4568,196,4712,24084,22608,1476
2/24/2016 18:00,33888,2902,103,4712,26171,25486,685
2/24/2016 19:00,35744,2628,0,4712,28404,26313,2091
2/24/2016 20:00,37404,3426,0,4712,29266,26085,3181
2/24/2016 21:00,37553,4076,0,4712,28765,24718,4047
2/24/2016 22:00,36771,4950,0,4712,27109,21922,5187
2/24/2016 23:00,34837,5797,0,4712,24328,19712,4616
2/25/2016 0:00,32868,6488,0,4712,21668,18007,3661
2/25/2016 1:00,31792,6788,0,4712,20292,17388,2904
2/25/2016 2:00,31417,6975,0,4712,19730,17503,2227
2/25/2016 3:00,31439,7084,0,4712,19643,17943,1700
2/25/2016 4:00,31887,6866,0,4712,20308,19081,1227
2/25/2016 5:00,33130,7119,0,4712,21299,21801,-502
2/25/2016 6:00,36266,6829,0,4712,24725,26495,-1770
2/25/2016 7:00,40907,7070,0,4712,29126,26951,2175
2/25/2016 8:00,41499,6434,198,4712,30154,26214,3940
2/25/2016 9:00,39374,5152,334,4712,29176,24306,4870
2/25/2016 10:00,37778,6128,410,4712,26527,23579,2948
2/25/2016 11:00,36644,4907,450,4712,26575,23624,2951
2/25/2016 12:00,35565,4089,470,4712,26294,23505,2789
2/25/2016 13:00,34774,3523,477,4712,26062,23569,2493
2/25/2016 14:00,34370,3167,470,4712,26022,23275,2747
2/25/2016 15:00,33903,3159,466,4712,25566,23225,2341
2/25/2016 16:00,33622,2980,433,4712,25498,23308,2190
2/25/2016 17:00,33634,2971,351,4712,25600,23668,1932
2/25/2016 18:00,33925,2919,187,4712,26107,25413,694
2/25/2016 19:00,35672,3360,0,4712,27600,26344,1256
2/25/2016 20:00,37276,4355,0,4712,28209,25485,2724
2/25/2016 21:00,37146,4293,0,4712,28141,24852,3289
2/25/2016 22:00,36142,4191,0,4712,27239,22677,4562
2/25/2016 23:00,34211,4262,0,4712,25237,20680,4557
2/26/2016 0:00,32240,4308,0,4712,23219,19721,3498
2/26/2016 1:00,31170,4604,0,4712,21854,19578,2276
2/26/2016 2:00,30928,4244,0,4712,21972,19998,1974
2/26/2016 3:00,31108,4179,0,4712,22217,20432,1785
2/26/2016 4:00,31753,4831,0,4712,22209,21164,1045
2/26/2016 5:00,33208,5391,0,4712,23105,23390,-285
2/26/2016 6:00,36466,5806,0,4712,25948,27220,-1272
2/26/2016 7:00,41112,6475,0,4712,29925,27733,2192
2/26/2016 8:00,41948,6692,189,4712,30355,26988,3367
2/26/2016 9:00,39961,4491,253,4712,30505,25918,4587
2/26/2016 10:00,38259,5479,276,4712,27792,24008,3784
2/26/2016 11:00,36939,5234,309,4712,26685,22898,3787
2/26/2016 12:00,35651,5139,297,4712,25503,22022,3481
2/26/2016 13:00,34535,4190,292,4712,25341,22831,2510
2/26/2016 14:00,33811,2811,369,4712,25919,23049,2870
2/26/2016 15:00,33196,2050,366,4712,26068,23319,2749
2/26/2016 16:00,32787,1789,368,4712,25918,23167,2751
2/26/2016 17:00,32561,1849,281,4712,25719,23212,2507
2/26/2016 18:00,32577,1820,121,4712,25924,24251,1673
2/26/2016 19:00,33891,2187,0,4712,26991,24693,2298
2/26/2016 20:00,35044,3025,0,4712,27307,23914,3393
2/26/2016 21:00,34793,3804,0,4712,26277,22713,3564
2/26/2016 22:00,34184,4566,0,4712,24906,20543,4363
2/26/2016 23:00,33007,5601,0,4712,22695,18183,4512
2/27/2016 0:00,31586,6374,0,4712,20499,16446,4053
2/27/2016 1:00,30559,6955,0,4712,18891,15924,2967
2/27/2016 2:00,30004,6724,0,4712,18568,16007,2561
2/27/2016 3:00,29880,6654,0,4712,18514,16313,2201
2/27/2016 4:00,30085,6742,0,4712,18631,16653,1978
2/27/2016 5:00,30672,6995,0,4712,18965,17570,1395
2/27/2016 6:00,31946,7382,0,4712,19852,18892,960
2/27/2016 7:00,33771,7664,0,4712,21395,19952,1443
2/27/2016 8:00,34867,7683,53,4712,22420,21163,1257
2/27/2016 9:00,35031,5400,129,4712,24790,21663,3127
2/27/2016 10:00,34327,4982,204,4712,24429,20795,3634
2/27/2016 11:00,33405,5305,214,4712,23173,19703,3470
2/27/2016 12:00,32554,5598,238,4712,22006,18258,3748
2/27/2016 13:00,31838,6862,249,4712,20015,15713,4302
2/27/2016 14:00,31253,8503,299,4712,17739,13984,3755
2/27/2016 15:00,30984,9543,267,4712,16462,13571,2891
2/27/2016 16:00,30975,9987,231,4712,16044,13256,2788
2/27/2016 17:00,31066,10504,170,4712,15681,13008,2673
2/27/2016 18:00,31137,10660,120,4712,15646,13796,1850
2/27/2016 19:00,32095,11473,0,4712,15911,13715,2196
2/27/2016 20:00,33105,12593,0,4712,15799,12978,2821
2/27/2016 21:00,32640,12752,0,4712,15177,12237,2940
2/27/2016 22:00,31864,12895,0,4712,14257,11163,3094
2/27/2016 23:00,30562,13159,0,4712,12691,10199,2492
2/28/2016 0:00,28975,12622,0,4712,11641,9471,2170
2/28/2016 1:00,27652,12209,0,4712,10730,9239,1491
2/28/2016 2:00,26866,11968,0,4712,10185,9329,856
2/28/2016 3:00,26451,11393,0,4712,10346,9336,1010
2/28/2016 4:00,26297,11156,0,4712,10429,9790,639
2/28/2016 5:00,26435,10510,0,4712,11213,10571,642
2/28/2016 6:00,27010,10084,0,4712,12213,11232,981
2/28/2016 7:00,27917,10703,0,4712,12503,11698,805
2/28/2016 8:00,28606,9998,50,4712,13846,13770,76
2/28/2016 9:00,29897,8767,153,4712,16265,14720,1545
2/28/2016 10:00,30822,7799,226,4712,18085,16223,1862
2/28/2016 11:00,31152,6544,255,4712,19641,16415,3226
2/28/2016 12:00,31208,6325,263,4712,19908,16770,3138
2/28/2016 13:00,31293,6196,265,4712,20120,16406,3714
2/28/2016 14:00,31292,6487,261,4712,19832,16151,3681
2/28/2016 15:00,31321,6186,248,4712,20175,16908,3267
2/28/2016 16:00,31427,5699,244,4712,20772,17635,3137
2/28/2016 17:00,31714,5356,208,4712,21438,18770,2668
2/28/2016 18:00,32226,4386,126,4712,23002,21023,1979
2/28/2016 19:00,33639,4251,0,4712,24676,21741,2935
2/28/2016 20:00,34981,4686,0,4712,25583,21213,4370
2/28/2016 21:00,34309,4397,0,4712,25200,20269,4931
2/28/2016 22:00,32914,4187,0,4712,24015,19101,4914
2/28/2016 23:00,30765,4136,0,4712,21917,17022,4895
2/29/2016 0:00,28343,4086,0,4712,19545,15206,4339
2/29/2016 1:00,26644,4128,0,4712,17804,14119,3685
2/29/2016 2:00,25697,4384,0,4712,16601,13699,2902
2/29/2016 3:00,25356,4327,0,4712,16316,13532,2784
2/29/2016 4:00,25399,4441,0,4712,16246,14151,2095
2/29/2016 5:00,26209,4611,0,4712,16886,16605,281
2/29/2016 6:00,28558,4401,0,4712,19445,20206,-761
2/29/2016 7:00,32411,4393,0,4712,23306,21168,2138
2/29/2016 8:00,33556,4395,50,4712,24399,21485,2914
2/29/2016 9:00,33554,3375,153,4712,25314,22275,3039
2/29/2016 10:00,34010,4428,226,4712,24644,21897,2747
2/29/2016 11:00,34535,5218,255,4712,24350,21342,3008
2/29/2016 12:00,34975,6568,263,4712,23432,20217,3215
2/29/2016 13:00,35351,8038,265,4712,22336,19603,2733
2/29/2016 14:00,35912,9013,261,4712,21926,19171,2755
2/29/2016 15:00,36310,9214,248,4712,22135,19169,2966
2/29/2016 16:00,36499,9808,244,4712,21736,19103,2633
2/29/2016 17:00,36553,9626,208,4712,22007,19291,2716
2/29/2016 18:00,36386,8887,126,4712,22660,20830,1830
2/29/2016 19:00,37083,8581,0,4712,23790,20870,2920
2/29/2016 20:00,37951,9967,0,4712,23272,19303,3969
2/29/2016 21:00,37057,10413,0,4712,21932,17400,4532
2/29/2016 22:00,35298,11278,0,4712,19309,14964,4345
2/29/2016 23:00,32511,11114,0,4712,16685,12814,3871
3/1/2016 0:00,29668,10408,0,4712,14547,12186,2361
3/1/2016 1:00,27678,9985,0,4712,12981,11729,1252
3/1/2016 2:00,26565,9659,0,4712,12195,11470,725
3/1/2016 3:00,25983,10052,0,4712,11218,11403,-185
3/1/2016 4:00,25865,9635,0,4712,11517,12117,-600
3/1/2016 5:00,26406,8884,0,4712,12810,13010,-200
3/1/2016 6:00,28449,10203,0,4712,13534,15518,-1984
3/1/2016 7:00,32164,9860,0,4712,17593,16284,1309
3/1/2016 8:00,33149,9417,32,4712,18988,17065,1923
3/1/2016 9:00,33426,9492,49,4712,19173,17040,2133
3/1/2016 10:00,34214,9362,62,4712,20078,18354,1724
3/1/2016 11:00,34833,8950,90,4712,21081,19413,1668
3/1/2016 12:00,35451,8051,172,4712,22516,20588,1928
3/1/2016 13:00,35877,6810,246,4712,24109,22322,1787
3/1/2016 14:00,36453,5623,250,4712,25868,24476,1392
3/1/2016 15:00,36651,3862,174,4712,27903,25384,2519
3/1/2016 16:00,36526,2807,142,4712,28865,26389,2476
3/1/2016 17:00,36542,2036,120,4712,29674,26367,3307
3/1/2016 18:00,36357,2138,98,4712,29408,26604,2804
3/1/2016 19:00,36747,2496,0,4712,29539,26724,2815
3/1/2016 20:00,37589,3351,0,4712,29526,25545,3981
3/1/2016 21:00,36882,4533,0,4712,27638,22979,4659
3/1/2016 22:00,35237,5623,0,4712,24902,19632,5270
3/1/2016 23:00,32502,5948,0,4712,21842,16626,5216
3/2/2016 0:00,29774,6516,0,4712,18546,14967,3579
3/2/2016 1:00,28037,7426,0,4712,15899,13154,2745
3/2/2016 2:00,27066,8310,0,4712,14044,12463,1581
3/2/2016 3:00,26717,9036,0,4712,12970,12195,775
3/2/2016 4:00,26784,9906,0,4712,12166,12422,-256
3/2/2016 5:00,27695,10432,0,4712,12551,13850,-1299
3/2/2016 6:00,30148,11245,0,4712,14191,16509,-2318
3/2/2016 7:00,34394,11291,0,4712,18391,17435,956
3/2/2016 8:00,35397,11131,20,4712,19534,17117,2417
3/2/2016 9:00,34897,10980,36,4712,19169,16960,2209
3/2/2016 10:00,34767,11047,70,4712,18938,17016,1922
3/2/2016 11:00,34688,10443,106,4712,19427,17276,2151
3/2/2016 12:00,34543,9686,128,4712,20017,17768,2249
3/2/2016 13:00,34500,9431,136,4712,20221,18128,2093
3/2/2016 14:00,34712,9356,197,4712,20447,17952,2495
3/2/2016 15:00,34818,9982,189,4712,19936,17567,2369
3/2/2016 16:00,34980,10301,135,4712,19832,17329,2503
3/2/2016 17:00,35001,10698,114,4712,19477,17634,1843
3/2/2016 18:00,34999,9579,50,4712,20657,19457,1200
3/2/2016 19:00,35964,10144,0,4712,21108,19364,1744
3/2/2016 20:00,36961,11448,0,4712,20801,18603,2198
3/2/2016 21:00,36321,10995,0,4712,20614,17458,3156
3/2/2016 22:00,34697,10635,0,4712,19350,15878,3472
3/2/2016 23:00,32241,10042,0,4712,17487,14475,3012
3/3/2016 0:00,29651,8667,0,4712,16272,14042,2230
3/3/2016 1:00,27807,6965,0,4712,16131,14405,1726
3/3/2016 2:00,26770,6507,0,4712,15551,13995,1556
3/3/2016 3:00,26183,6217,0,4712,15254,13863,1391
3/3/2016 4:00,26070,6927,0,4712,14430,13326,1104
3/3/2016 5:00,26669,8543,0,4712,13414,13889,-475
3/3/2016 6:00,28800,9092,0,4712,14996,16112,-1116
3/3/2016 7:00,32578,9628,0,4712,18238,16391,1847
3/3/2016 8:00,33593,9855,13,4712,19013,17144,1869
3/3/2016 9:00,33983,9374,55,4712,19841,17470,2371
3/3/2016 10:00,34725,9478,79,4712,20456,19281,1175
3/3/2016 11:00,35552,8472,97,4712,22271,20656,1615
3/3/2016 12:00,36239,7858,98,4712,23570,21878,1692
3/3/2016 13:00,36687,7173,106,4712,24697,23786,911
3/3/2016 14:00,37372,5505,109,4712,27046,25819,1227
3/3/2016 15:00,38038,3637,102,4712,29587,27531,2056
3/3/2016 16:00,38365,2275,82,4712,31296,28509,2787
3/3/2016 17:00,38388,1641,37,4712,31998,28283,3715
3/3/2016 18:00,37722,1376,9,4712,31626,28250,3376
3/3/2016 19:00,37612,1517,0,4712,31383,28912,2471
3/3/2016 20:00,38057,1664,0,4712,31680,27927,3753
3/3/2016 21:00,36902,2049,0,4712,30141,26100,4041
3/3/2016 22:00,35037,2313,0,4712,28012,22772,5240
3/3/2016 23:00,32333,2893,0,4712,24728,19942,4786
3/4/2016 0:00,29476,3682,0,4712,21082,17614,3468
3/4/2016 1:00,27661,4627,0,4712,18322,15620,2702
3/4/2016 2:00,26657,5728,0,4712,16218,14192,2026
3/4/2016 3:00,26208,6857,0,4712,14639,13396,1243
3/4/2016 4:00,26290,7819,0,4712,13758,13174,584
3/4/2016 5:00,27138,8673,0,4712,13753,14550,-797
3/4/2016 6:00,29634,9838,0,4712,15083,17016,-1933
3/4/2016 7:00,33699,10450,0,4712,18537,17643,894
3/4/2016 8:00,34710,10107,18,4712,19872,18164,1708
3/4/2016 9:00,34267,8432,132,4712,20991,18574,2417
3/4/2016 10:00,34183,8775,198,4712,20497,18301,2196
3/4/2016 11:00,34283,9138,107,4712,20326,18099,2227
3/4/2016 12:00,34408,9364,186,4712,20145,18569,1576
3/4/2016 13:00,34451,8450,129,4712,21160,20034,1126
3/4/2016 14:00,34870,7628,206,4712,22324,21062,1262
3/4/2016 15:00,35073,6455,53,4712,23852,21877,1975
3/4/2016 16:00,35131,5783,98,4712,24538,22126,2412
3/4/2016 17:00,34967,5211,90,4712,24954,21931,3023
3/4/2016 18:00,34470,5373,51,4712,24334,21207,3127
3/4/2016 19:00,34593,7639,0,4712,22242,19691,2551
3/4/2016 20:00,35029,9458,0,4712,20859,18040,2819
3/4/2016 21:00,34170,9407,0,4712,20051,16799,3252
3/4/2016 22:00,33000,10042,0,4712,18246,15142,3104
3/4/2016 23:00,31180,9738,0,4712,16730,13508,3222
3/5/2016 0:00,29216,9591,0,4712,14914,12488,2426
3/5/2016 1:00,27591,8745,0,4712,14134,12562,1572
3/5/2016 2:00,26603,7696,0,4712,14195,13348,847
3/5/2016 3:00,26109,5775,0,4712,15622,14100,1522
3/5/2016 4:00,25961,5632,0,4712,15617,14951,666
3/5/2016 5:00,26176,4795,0,4712,16669,16319,350
3/5/2016 6:00,27037,4086,0,4712,18239,17513,726
3/5/2016 7:00,28544,4031,0,4712,19801,18848,953
3/5/2016 8:00,29586,3338,71,4712,21466,20730,736
3/5/2016 9:00,30784,2364,227,4712,23482,21629,1853
3/5/2016 10:00,31524,2350,397,4712,24066,21983,2083
3/5/2016 11:00,32121,2509,452,4712,24448,22042,2406
3/5/2016 12:00,32523,2835,464,4712,24511,21785,2726
3/5/2016 13:00,32809,4315,474,4712,23307,20822,2485
3/5/2016 14:00,33161,5839,469,4712,22141,20053,2088
3/5/2016 15:00,33632,6882,449,4712,21589,19624,1965
3/5/2016 16:00,33997,7365,408,4712,21512,19409,2103
3/5/2016 17:00,34101,7636,368,4712,21385,19269,2116
3/5/2016 18:00,33732,6911,224,4712,21885,20002,1883
3/5/2016 19:00,33950,7090,0,4712,22148,19462,2686
3/5/2016 20:00,34516,8771,0,4712,21033,17142,3891
3/5/2016 21:00,33585,9988,0,4712,18885,15274,3611
3/5/2016 22:00,32474,10866,0,4712,16896,13278,3618
3/5/2016 23:00,30820,11484,0,4712,14623,11525,3098
3/6/2016 0:00,28933,11298,0,4712,12923,10500,2423
3/6/2016 1:00,27345,10688,0,4712,11944,9948,1996
3/6/2016 2:00,26232,10297,0,4712,11222,9817,1405
3/6/2016 3:00,25539,9795,0,4712,11032,9778,1254
3/6/2016 4:00,25214,9619,0,4712,10884,9907,977
3/6/2016 5:00,25208,9515,0,4712,10980,10565,415
3/6/2016 6:00,25659,9790,0,4712,11156,10998,158
3/6/2016 7:00,26474,10053,0,4712,11709,11221,488
3/6/2016 8:00,27216,10456,185,4712,11863,12203,-340
3/6/2016 9:00,28868,11313,365,4712,12479,12793,-314
3/6/2016 10:00,30289,11815,444,4712,13318,13068,250
3/6/2016 11:00,31120,12007,469,4712,13932,13636,296
3/6/2016 12:00,31633,11812,487,4712,14621,14064,557
3/6/2016 13:00,32064,11849,488,4712,15015,14576,439
3/6/2016 14:00,32321,10988,484,4712,16136,15222,914
3/6/2016 15:00,32529,10956,465,4712,16396,15082,1314
3/6/2016 16:00,32744,11750,428,4712,15854,14511,1343
3/6/2016 17:00,33002,12542,333,4712,15414,14380,1034
3/6/2016 18:00,33393,12809,242,4712,15630,15177,453
3/6/2016 19:00,34648,13441,0,4712,16495,16041,454
3/6/2016 20:00,35865,13574,0,4712,17580,15024,2556
3/6/2016 21:00,35116,13672,0,4712,16732,13516,3216
3/6/2016 22:00,33785,13963,0,4712,15110,11854,3256
3/6/2016 23:00,31639,13274,0,4712,13653,10881,2772
3/7/2016 0:00,29178,11943,0,4712,12523,10075,2448
3/7/2016 1:00,27406,11691,0,4712,11002,9600,1402
3/7/2016 2:00,26372,11244,0,4712,10416,9543,873
3/7/2016 3:00,25888,11121,0,4712,10055,9662,393
3/7/2016 4:00,25828,11047,0,4712,10069,10320,-251
3/7/2016 5:00,26456,11208,0,4712,10535,11792,-1257
3/7/2016 6:00,28497,11777,0,4712,12008,14138,-2130
3/7/2016 7:00,31825,11398,0,4712,15714,16075,-361
3/7/2016 8:00,33054,10275,122,4712,17945,17209,736
3/7/2016 9:00,33668,9799,174,4712,18983,18799,184
3/7/2016 10:00,34594,8996,124,4712,20762,20150,612
3/7/2016 11:00,35430,8630,165,4712,21924,21145,779
3/7/2016 12:00,36095,7644,242,4712,23497,21956,1541
3/7/2016 13:00,36348,6844,252,4712,24541,22239,2302
3/7/2016 14:00,36576,6839,297,4712,24728,22059,2669
3/7/2016 15:00,36548,7136,119,4712,24581,21500,3081
3/7/2016 16:00,36338,7415,168,4712,24043,21439,2604
3/7/2016 17:00,36236,7408,104,4712,24012,21748,2264
3/7/2016 18:00,36389,6883,13,4712,24781,22535,2246
3/7/2016 19:00,37458,7946,0,4712,24801,22106,2695
3/7/2016 20:00,37975,8240,0,4712,25023,20833,4190
3/7/2016 21:00,37136,9078,0,4712,23346,19529,3817
3/7/2016 22:00,35671,9527,0,4712,21432,16529,4903
3/7/2016 23:00,33177,10130,0,4712,18334,14390,3944
3/8/2016 0:00,30610,10014,0,4712,15884,12989,2895
3/8/2016 1:00,28736,9715,0,4712,14309,12643,1666
3/8/2016 2:00,27670,8962,0,4712,13996,12948,1048
3/8/2016 3:00,27003,8125,0,4712,14166,13090,1076
3/8/2016 4:00,26778,7168,0,4712,14898,14290,608
3/8/2016 5:00,27250,7739,0,4712,14800,16157,-1357
3/8/2016 6:00,29179,6480,0,4712,17987,19326,-1339
3/8/2016 7:00,32494,5947,0,4712,21835,20804,1031
3/8/2016 8:00,33753,4446,9,4712,24587,22696,1891
3/8/2016 9:00,34223,3489,42,4712,25979,23556,2423
3/8/2016 10:00,34997,2725,162,4712,27399,25062,2337
3/8/2016 11:00,35777,2592,231,4712,28242,25620,2622
3/8/2016 12:00,36267,2342,266,4712,28947,26369,2578
3/8/2016 13:00,36822,2099,278,4712,29734,26681,3053
3/8/2016 14:00,37083,2095,274,4712,30002,26976,3026
3/8/2016 15:00,37168,2166,270,4712,30020,27052,2968
3/8/2016 16:00,37339,2820,240,4712,29566,26525,3041
3/8/2016 17:00,37454,3955,133,4712,28654,25673,2981
3/8/2016 18:00,37371,4803,51,4712,27805,25553,2252
3/8/2016 19:00,38083,5127,0,4712,28244,25466,2778
3/8/2016 20:00,38650,5073,0,4712,28865,25860,3005
3/8/2016 21:00,37852,4310,0,4712,28831,24487,4344
3/8/2016 22:00,36102,4637,0,4712,26753,21752,5001
3/8/2016 23:00,33530,4603,0,4712,24215,19059,5156
3/9/2016 0:00,30748,4375,0,4712,21660,17944,3716
3/9/2016 1:00,28713,3480,0,4712,20521,18037,2484
3/9/2016 2:00,27299,2441,0,4712,20145,18185,1960
3/9/2016 3:00,26507,1385,0,4712,20409,18354,2055
3/9/2016 4:00,26318,1433,0,4712,20173,18561,1612
3/9/2016 5:00,26783,2062,0,4712,20008,18814,1194
3/9/2016 6:00,28583,3157,0,4712,20713,21041,-328
3/9/2016 7:00,31869,3193,0,4712,23964,22478,1486
3/9/2016 8:00,33188,3538,55,4712,24883,22944,1939
3/9/2016 9:00,33867,4076,79,4712,25000,23032,1968
3/9/2016 10:00,34626,4412,104,4712,25398,23578,1820
3/9/2016 11:00,35226,4687,126,4712,25701,24211,1490
3/9/2016 12:00,35514,3559,136,4712,27107,25271,1836
3/9/2016 13:00,35431,2833,164,4712,27722,25164,2558
3/9/2016 14:00,35278,3314,275,4712,26977,24382,2595
3/9/2016 15:00,34830,3289,337,4712,26492,24275,2217
3/9/2016 16:00,34433,2920,324,4712,26477,24811,1666
3/9/2016 17:00,34379,2415,244,4712,27008,25276,1732
3/9/2016 18:00,34990,2170,189,4712,27919,26175,1744
3/9/2016 19:00,35884,2822,0,4712,28349,25951,2398
3/9/2016 20:00,36120,3006,0,4712,28402,24971,3431
3/9/2016 21:00,35361,2644,0,4712,28005,23896,4109
3/9/2016 22:00,33858,2612,0,4712,26534,21181,5353
3/9/2016 23:00,31497,3120,0,4712,23665,18790,4875
3/10/2016 0:00,29091,2828,0,4712,21551,18192,3359
3/10/2016 1:00,27325,2323,0,4712,20290,17889,2401
3/10/2016 2:00,26485,2155,0,4712,19618,18029,1589
3/10/2016 3:00,25974,1598,0,4712,19665,17485,2180
3/10/2016 4:00,25936,2185,0,4712,19039,17282,1757
3/10/2016 5:00,26524,3096,0,4712,18716,18591,125
3/10/2016 6:00,28337,3600,0,4712,20025,20979,-954
3/10/2016 7:00,31678,3411,0,4712,23555,21884,1671
3/10/2016 8:00,32726,3453,105,4712,24457,21191,3266
3/10/2016 9:00,33013,4924,211,4712,23166,20640,2526
3/10/2016 10:00,33699,5665,305,4712,23017,21149,1868
3/10/2016 11:00,34272,6268,389,4712,22902,20649,2253
3/10/2016 12:00,34582,7071,416,4712,22383,20440,1943
3/10/2016 13:00,34796,7390,404,4712,22290,20354,1936
3/10/2016 14:00,35081,7850,434,4712,22084,20533,1551
3/10/2016 15:00,35293,7233,403,4712,22945,20426,2519
3/10/2016 16:00,35142,7347,400,4712,22683,20810,1873
3/10/2016 17:00,34957,6465,328,4712,23452,21356,2096
3/10/2016 18:00,35004,6235,203,4712,23855,22234,1621
3/10/2016 19:00,35912,5620,0,4712,25580,22646,2934
3/10/2016 20:00,36400,5645,0,4712,26042,21875,4167
3/10/2016 21:00,35762,6405,0,4712,24644,20845,3799
3/10/2016 22:00,34373,6159,0,4712,23501,19365,4136
3/10/2016 23:00,32109,5723,0,4712,21673,17620,4053
3/11/2016 0:00,29628,5563,0,4712,19353,15814,3539
3/11/2016 1:00,27827,6066,0,4712,17049,14600,2449
3/11/2016 2:00,26755,6187,0,4712,15856,13791,2065
3/11/2016 3:00,26110,6255,0,4712,15143,14253,890
3/11/2016 4:00,25807,5679,0,4712,15416,14998,418
3/11/2016 5:00,26352,5624,0,4712,16016,16292,-276
3/11/2016 6:00,28223,6592,0,4712,16919,18228,-1309
3/11/2016 7:00,31488,6466,0,4712,20310,19926,384
3/11/2016 8:00,32598,5798,156,4712,21933,21240,693
3/11/2016 9:00,33118,5054,315,4712,23037,22138,899
3/11/2016 10:00,33984,5196,367,4712,23709,22622,1087
3/11/2016 11:00,34641,5564,403,4712,23962,22781,1181
3/11/2016 12:00,35112,5688,388,4712,24324,22941,1383
3/11/2016 13:00,35319,5618,398,4712,24591,23900,691
3/11/2016 14:00,35518,4699,379,4712,25728,24295,1433
3/11/2016 15:00,35605,4227,349,4712,26317,24666,1651
3/11/2016 16:00,35487,4123,342,4712,26310,24718,1592
3/11/2016 17:00,35128,3053,278,4712,27085,25040,2045
3/11/2016 18:00,34649,2564,179,4712,27194,25709,1485
3/11/2016 19:00,34879,1839,0,4712,28327,26175,2152
3/11/2016 20:00,35220,2112,0,4712,28396,25539,2857
3/11/2016 21:00,34481,2061,0,4712,27708,24390,3318
3/11/2016 22:00,33279,2018,0,4712,26549,22925,3624
3/11/2016 23:00,31597,1565,0,4712,25320,21447,3873
3/12/2016 0:00,29637,1362,0,4712,23562,20502,3060
3/12/2016 1:00,27953,978,0,4712,22263,20292,1971
3/12/2016 2:00,26807,607,0,4712,21488,19975,1513
3/12/2016 3:00,26113,428,0,4712,20974,19620,1354
3/12/2016 4:00,25712,548,0,4712,20452,19682,770
3/12/2016 5:00,25782,480,0,4712,20590,19874,716
3/12/2016 6:00,26380,593,0,4712,21075,20791,284
3/12/2016 7:00,27381,531,0,4712,22138,21643,495
3/12/2016 8:00,28323,553,237,4712,22821,23252,-431
3/12/2016 9:00,29996,651,311,4712,24322,24185,137
3/12/2016 10:00,31359,769,416,4712,25462,24825,637
3/12/2016 11:00,32251,887,428,4712,26224,24848,1376
3/12/2016 12:00,32721,1328,414,4712,26267,24858,1409
3/12/2016 13:00,32868,1656,448,4712,26053,24510,1543
3/12/2016 14:00,32942,2102,404,4712,25724,24080,1644
3/12/2016 15:00,33059,2935,387,4712,25025,23473,1552
3/12/2016 16:00,33177,3837,335,4712,24293,22539,1754
3/12/2016 17:00,33207,5060,261,4712,23174,21690,1484
3/12/2016 18:00,33155,5734,212,4712,22497,21081,1416
3/12/2016 19:00,33266,7138,0,4712,21416,20054,1362
3/12/2016 20:00,34092,8943,0,4712,20438,17268,3170
3/12/2016 21:00,33355,10901,0,4712,17742,15679,2063
3/12/2016 22:00,32225,10486,0,4712,17026,14611,2415
3/12/2016 23:00,30551,9807,0,4712,16032,13276,2756
3/13/2016 0:00,28705,10083,0,4712,13909,12207,1702
3/13/2016 1:00,27114,9516,0,4712,12886,11828,1058
3/13/2016 2:00,26550,8648,0,,17903,11720,6183
3/13/2016 3:00,25986,8570,0,4712,12705,11542,1163
3/13/2016 4:00,25363,8990,0,4712,11661,11822,-161
3/13/2016 5:00,25162,8454,0,4712,11996,12340,-344
3/13/2016 6:00,25375,9079,0,4712,11584,12915,-1331
3/13/2016 7:00,26076,8891,2,4712,12471,13300,-829
3/13/2016 8:00,26871,9754,113,4712,12292,13821,-1529
3/13/2016 9:00,27597,10260,240,4712,12385,14484,-2099
3/13/2016 10:00,28962,10553,338,4712,13359,15756,-2397
3/13/2016 11:00,30213,10181,429,4712,14891,16689,-1798
3/13/2016 12:00,31368,10115,490,4712,16051,17528,-1477
3/13/2016 13:00,32411,9733,498,4712,17468,18626,-1158
3/13/2016 14:00,33308,8403,492,4712,19701,20314,-613
3/13/2016 15:00,34118,6915,477,4712,22014,22199,-185
3/13/2016 16:00,34945,5760,374,4712,24099,23834,265
3/13/2016 17:00,35687,4356,331,4712,26289,25339,950
3/13/2016 18:00,36131,2354,181,4712,28884,26528,2356
3/13/2016 19:00,35910,1695,0,4712,29503,27057,2446
3/13/2016 20:00,35614,2040,0,4712,28862,25371,3491
3/13/2016 21:00,36275,2830,0,4712,28734,22762,5972
3/13/2016 22:00,35080,3950,0,4712,26418,19536,6882
3/13/2016 23:00,33017,4778,0,4712,23527,16633,6894
3/14/2016 0:00,30296,6148,0,4712,19436,14903,4533
3/14/2016 1:00,27985,6476,0,4712,16797,14407,2390
3/14/2016 2:00,26486,6512,0,4712,15262,14207,1055
3/14/2016 3:00,25644,6597,0,4712,14335,14355,-20
3/14/2016 4:00,25363,6949,0,4712,13701,15207,-1506
3/14/2016 5:00,25739,7326,0,4712,13701,17038,-3337
3/14/2016 6:00,27310,7564,0,4712,15034,18056,-3022
3/14/2016 7:00,29912,8476,0,4712,16724,17597,-873
3/14/2016 8:00,31702,8243,165,4712,18581,19102,-521
3/14/2016 9:00,32049,6774,328,4712,20235,20496,-261
3/14/2016 10:00,32788,6895,408,4712,20773,21464,-691
3/14/2016 11:00,33941,7433,479,4712,21316,22407,-1091
3/14/2016 12:00,35279,7701,494,4712,22372,23508,-1136
3/14/2016 13:00,36648,8270,492,4712,23173,24606,-1433
3/14/2016 14:00,38409,8562,489,4712,24646,25645,-999
3/14/2016 15:00,39952,8348,407,4712,26485,26332,153
3/14/2016 16:00,41266,8507,426,4712,27621,26153,1468
3/14/2016 17:00,42203,9002,354,4712,28135,25388,2747
3/14/2016 18:00,42409,9068,238,4712,28391,24519,3872
3/14/2016 19:00,41609,9325,0,4712,27572,23755,3817
3/14/2016 20:00,40523,10109,0,4712,25701,22318,3383
3/14/2016 21:00,40498,10139,0,4712,25647,19812,5835
3/14/2016 22:00,38620,10357,0,4712,23551,17164,6387
3/14/2016 23:00,36105,10457,0,4712,20936,15316,5620
3/15/2016 0:00,32940,10037,0,4712,18191,13632,4559
3/15/2016 1:00,30310,9779,0,4712,15819,12891,2928
3/15/2016 2:00,28594,9501,0,4712,14381,12757,1624
3/15/2016 3:00,27603,9318,0,4712,13573,12867,706
3/15/2016 4:00,27100,9452,0,4712,12936,13694,-758
3/15/2016 5:00,27366,9464,0,4712,13190,15094,-1904
3/15/2016 6:00,28675,10522,0,4712,13441,16508,-3067
3/15/2016 7:00,31173,10285,1,4712,16175,17339,-1164
3/15/2016 8:00,32809,9312,191,4712,18594,19232,-638
3/15/2016 9:00,33042,8297,351,4712,19681,20893,-1212
3/15/2016 10:00,34141,7910,388,4712,21131,23000,-1869
3/15/2016 11:00,35589,7662,374,4712,22842,24222,-1380
3/15/2016 12:00,37130,7624,467,4712,24327,25910,-1583
3/15/2016 13:00,38632,6807,411,4712,26703,27576,-873
3/15/2016 14:00,40304,5792,411,4712,29389,28820,569
3/15/2016 15:00,41624,6001,356,4712,30554,29422,1132
3/15/2016 16:00,42533,5487,362,4712,31972,30009,1963
3/15/2016 17:00,43158,4447,285,4712,33715,30509,3206
3/15/2016 18:00,42993,2701,157,4712,35424,30325,5099
3/15/2016 19:00,41755,2732,0,4712,34312,30486,3826
3/15/2016 20:00,40752,3187,0,4712,32854,28560,4294
3/15/2016 21:00,40770,3155,0,4712,32903,25020,7883
3/15/2016 22:00,38918,3844,0,4712,30362,21794,8568
3/15/2016 23:00,36072,4200,0,4712,27160,19760,7400
3/16/2016 0:00,32771,4082,0,4712,23977,18227,5750
3/16/2016 1:00,30296,4187,0,4712,21397,17272,4125
3/16/2016 2:00,28599,4076,0,4712,19812,17042,2770
3/16/2016 3:00,27507,3792,0,4712,19003,17292,1711
3/16/2016 4:00,26909,3678,0,4712,18520,18708,-188
3/16/2016 5:00,27085,3648,0,4712,18725,20930,-2205
3/16/2016 6:00,28482,3725,0,4712,20044,22238,-2194
3/16/2016 7:00,30986,4637,1,4712,21637,22171,-534
3/16/2016 8:00,32819,4046,148,4712,23914,23892,22
3/16/2016 9:00,33071,2952,250,4712,25157,24066,1091
3/16/2016 10:00,33823,4924,266,4712,23922,24142,-220
3/16/2016 11:00,34738,5134,304,4712,24588,25178,-590
3/16/2016 12:00,35678,4392,263,4712,26311,26663,-352
3/16/2016 13:00,36361,3453,317,4712,27879,28222,-343
3/16/2016 14:00,37243,2692,254,4712,29586,29204,382
3/16/2016 15:00,38038,2120,100,4712,31106,30353,753
3/16/2016 16:00,38696,1551,193,4712,32240,30835,1405
3/16/2016 17:00,39321,1146,184,4712,33279,30454,2825
3/16/2016 18:00,39291,1404,142,4712,33033,29896,3137
3/16/2016 19:00,38787,2647,0,4712,31428,28900,2528
3/16/2016 20:00,38478,4298,0,4712,29468,26402,3066
3/16/2016 21:00,39055,5557,0,4712,28786,23335,5451
3/16/2016 22:00,37705,6279,0,4712,26714,20147,6567
3/16/2016 23:00,35356,6592,0,4712,24052,18297,5755
3/17/2016 0:00,32511,6217,0,4712,21581,17467,4114
3/17/2016 1:00,30138,5417,0,4712,20009,17328,2681
3/17/2016 2:00,28670,4550,0,4712,19408,17691,1717
3/17/2016 3:00,27688,3627,0,4712,19349,18650,699
3/17/2016 4:00,27179,2715,0,4712,19752,20389,-637
3/17/2016 5:00,27410,2509,0,4712,20189,22988,-2799
3/17/2016 6:00,28816,2173,0,4712,21932,24700,-2768
3/17/2016 7:00,31393,1947,0,4712,24735,25120,-385
3/17/2016 8:00,33216,1840,18,4712,26646,26172,474
3/17/2016 9:00,33565,1763,57,4712,27033,27166,-133
3/17/2016 10:00,34432,1891,97,4712,27732,27770,-38
3/17/2016 11:00,35641,1596,178,4712,29155,28313,842
3/17/2016 12:00,36508,1247,203,4712,30346,29069,1277
3/17/2016 13:00,36922,852,201,4712,31156,29626,1530
3/17/2016 14:00,37494,750,202,4712,31830,29885,1945
3/17/2016 15:00,38001,913,161,4712,32216,29966,2250
3/17/2016 16:00,38348,1339,143,4712,32155,29555,2600
3/17/2016 17:00,38722,1512,87,4712,32411,29277,3134
3/17/2016 18:00,38569,1420,38,4712,32400,29083,3317
3/17/2016 19:00,38105,2108,0,4712,31284,28930,2354
3/17/2016 20:00,38064,3466,0,4712,29886,26580,3306
3/17/2016 21:00,38580,4474,0,4712,29394,23725,5669
3/17/2016 22:00,37245,5160,0,4712,27373,20951,6422
3/17/2016 23:00,35007,5898,0,4712,24397,18842,5555
3/18/2016 0:00,32363,5333,0,4712,22318,17743,4575
3/18/2016 1:00,30192,5468,0,4712,20012,17044,2968
3/18/2016 2:00,28771,5232,0,4712,18827,16455,2372
3/18/2016 3:00,27893,5397,0,4712,17784,16388,1396
3/18/2016 4:00,27377,6175,0,4712,16491,16787,-296
3/18/2016 5:00,27640,6339,0,4712,16589,18732,-2143
3/18/2016 6:00,28987,6265,0,4712,18010,20765,-2755
3/18/2016 7:00,31380,5977,0,4712,20691,21428,-737
3/18/2016 8:00,33002,5186,11,4712,23093,22888,205
3/18/2016 9:00,33454,4877,39,4712,23825,23933,-108
3/18/2016 10:00,34483,4967,133,4712,24670,24098,572
3/18/2016 11:00,35591,6594,142,4712,24143,23241,902
3/18/2016 12:00,36569,7832,270,4712,23755,23259,496
3/18/2016 13:00,37528,8658,363,4712,23795,23381,414
3/18/2016 14:00,38474,8785,336,4712,24641,23937,704
3/18/2016 15:00,39282,8707,325,4712,25538,23893,1645
3/18/2016 16:00,39855,9402,345,4712,25395,23229,2166
3/18/2016 17:00,40193,10219,297,4712,24964,21607,3357
3/18/2016 18:00,39955,10805,162,4712,24276,20795,3481
3/18/2016 19:00,38861,10406,0,4712,23743,21175,2568
3/18/2016 20:00,38277,10013,0,4712,23552,19470,4082
3/18/2016 21:00,37884,10920,0,4712,22252,17554,4698
3/18/2016 22:00,36365,11170,0,4712,20482,15472,5010
3/18/2016 23:00,34503,11713,0,4712,18078,14067,4011
3/19/2016 0:00,32320,11168,0,4712,16440,13270,3170
3/19/2016 1:00,30375,10391,0,4712,15272,12710,2562
3/19/2016 2:00,28855,9853,0,4712,14290,12912,1378
3/19/2016 3:00,27873,9313,0,4712,13848,13114,734
3/19/2016 4:00,27373,8563,0,4712,14098,14736,-638
3/19/2016 5:00,27358,7254,0,4712,15393,16294,-901
3/19/2016 6:00,27968,7271,0,4712,15985,17929,-1944
3/19/2016 7:00,29195,6793,0,4712,17689,18855,-1166
3/19/2016 8:00,30722,7077,52,4712,18880,20078,-1198
3/19/2016 9:00,31975,5985,220,4712,21059,21535,-476
3/19/2016 10:00,33005,5161,271,4712,22861,21735,1126
3/19/2016 11:00,33483,4601,296,4712,23873,21299,2574
3/19/2016 12:00,33287,4986,312,4712,23277,20723,2554
3/19/2016 13:00,32689,4458,320,4712,23199,20589,2610
3/19/2016 14:00,31968,4050,288,4712,22918,20607,2311
3/19/2016 15:00,31236,3623,287,4712,22614,20191,2423
3/19/2016 16:00,30759,3725,276,4712,22046,20053,1993
3/19/2016 17:00,30521,3563,168,4712,22079,20050,2029
3/19/2016 18:00,30435,3731,52,4712,21940,21243,697
3/19/2016 19:00,30422,3470,0,4712,22240,22281,-41
3/19/2016 20:00,31224,4044,0,4712,22467,21742,725
3/19/2016 21:00,32733,4702,0,4712,23318,20801,2517
3/19/2016 22:00,32520,4485,0,4712,23322,20200,3122
3/19/2016 23:00,31578,4046,0,4712,22820,19452,3368
3/20/2016 0:00,30196,3698,0,4712,21786,18747,3039
3/20/2016 1:00,28936,3855,0,4712,20369,18049,2320
3/20/2016 2:00,28096,3975,0,4712,19409,18324,1085
3/20/2016 3:00,27684,3486,0,4712,19485,18608,877
3/20/2016 4:00,27609,3641,0,4712,19256,19533,-277
3/20/2016 5:00,27881,2990,0,4712,20179,20893,-714
3/20/2016 6:00,28647,2894,0,4712,21041,22325,-1284
3/20/2016 7:00,29977,2783,0,4712,22482,23246,-764
3/20/2016 8:00,31444,2149,32,4712,24551,24109,442
3/20/2016 9:00,32443,1878,59,4712,25794,23878,1916
3/20/2016 10:00,32914,1981,130,4712,26091,23517,2574
3/20/2016 11:00,32870,1757,117,4712,26284,23425,2859
3/20/2016 12:00,32483,1729,144,4712,25898,22927,2971
3/20/2016 13:00,32043,1621,158,4712,25552,22636,2916
3/20/2016 14:00,31454,1457,158,4712,25126,22220,2906
3/20/2016 15:00,30939,1436,74,4712,24716,22163,2553
3/20/2016 16:00,30522,1240,77,4712,24494,22605,1889
3/20/2016 17:00,30451,981,53,4712,24705,23241,1464
3/20/2016 18:00,30668,852,20,4712,25084,24613,471
3/20/2016 19:00,31059,1067,0,4712,25280,25479,-199
3/20/2016 20:00,32260,2396,0,4712,25152,23950,1202
3/20/2016 21:00,34495,4064,0,4712,25719,21142,4577
3/20/2016 22:00,34224,5362,0,4712,24151,18881,5270
3/20/2016 23:00,32644,6513,0,4712,21418,16607,4811
3/21/2016 0:00,30699,7562,0,4712,18425,15325,3100
3/21/2016 1:00,29418,8660,0,4712,16047,14282,1765
3/21/2016 2:00,28918,9719,0,4712,14486,14116,370
3/21/2016 3:00,29011,10319,0,4712,13980,14867,-887
3/21/2016 4:00,29534,10721,0,4712,14101,17273,-3172
3/21/2016 5:00,30747,10713,0,4712,15322,21566,-6244
3/21/2016 6:00,33798,11074,0,4712,18012,23945,-5933
3/21/2016 7:00,38654,9759,0,4712,24182,22916,1266
3/21/2016 8:00,40763,9556,6,4712,26489,21916,4573
3/21/2016 9:00,39604,10099,31,4712,24762,20242,4520
3/21/2016 10:00,38271,10503,78,4712,22979,19261,3718
3/21/2016 11:00,37224,9960,57,4712,22495,18919,3576
3/21/2016 12:00,36098,9477,62,4712,21847,18192,3655
3/21/2016 13:00,35081,9529,71,4712,20769,17547,3222
3/21/2016 14:00,34354,9562,105,4712,19975,16992,2983
3/21/2016 15:00,33725,9824,109,4712,19079,16606,2473
3/21/2016 16:00,33296,10245,109,4712,18230,15969,2261
3/21/2016 17:00,33258,10835,84,4712,17628,15560,2068
3/21/2016 18:00,33211,11402,51,4712,17046,16242,804
3/21/2016 19:00,33186,11515,0,4712,16959,17505,-546
3/21/2016 20:00,33949,12251,0,4712,16986,16130,856
3/21/2016 21:00,35669,12656,0,4712,18301,14113,4188
3/21/2016 22:00,34925,12893,0,4712,17319,11897,5422
3/21/2016 23:00,32669,12719,0,4712,15238,10429,4809
3/22/2016 0:00,30172,12902,0,4712,12558,9800,2758
3/22/2016 1:00,28607,12923,0,4712,10972,9640,1332
3/22/2016 2:00,27892,12952,0,4712,10228,9677,551
3/22/2016 3:00,27584,12995,0,4712,9877,10587,-710
3/22/2016 4:00,27729,12927,0,4712,10090,13122,-3032
3/22/2016 5:00,28659,12839,0,4712,11109,16567,-5458
3/22/2016 6:00,31114,12872,0,4712,13530,18063,-4533
3/22/2016 7:00,35253,12801,14,4712,17726,17996,-270
3/22/2016 8:00,36943,11323,231,4712,20676,17846,2830
3/22/2016 9:00,35895,11600,286,4712,19297,17176,2121
3/22/2016 10:00,35156,11658,340,4712,18446,16649,1797
3/22/2016 11:00,34747,11978,464,4712,17594,16013,1581
3/22/2016 12:00,34392,12283,505,4712,16892,15609,1283
3/22/2016 13:00,34037,12509,505,4712,16311,15399,912
3/22/2016 14:00,34071,12671,498,4712,16190,15518,672
3/22/2016 15:00,34041,12683,463,4712,16184,15818,366
3/22/2016 16:00,34206,13193,443,4712,15859,16008,-149
3/22/2016 17:00,34499,12980,407,4712,16400,15782,618
3/22/2016 18:00,34608,13033,264,4712,16599,16117,482
3/22/2016 19:00,34416,13219,0,4712,16485,17581,-1096
3/22/2016 20:00,34922,13223,0,4712,16987,16284,703
3/22/2016 21:00,36315,13586,0,4712,18017,14064,3953
3/22/2016 22:00,35263,13488,0,4712,17063,11611,5452
3/22/2016 23:00,32856,13236,0,4712,14908,10169,4739
3/23/2016 0:00,30032,12897,0,4712,12423,9601,2822
3/23/2016 1:00,28061,12369,0,4712,10980,9550,1430
3/23/2016 2:00,26884,12105,0,4712,10067,9496,571
3/23/2016 3:00,26280,12204,0,4712,9364,9817,-453
3/23/2016 4:00,26098,12217,0,4712,9169,11514,-2345
3/23/2016 5:00,26588,12352,0,4712,9524,14292,-4768
3/23/2016 6:00,28469,12428,0,4712,11329,15895,-4566
3/23/2016 7:00,32058,12350,28,4712,14967,15963,-996
3/23/2016 8:00,33787,11423,266,4712,17387,17346,41
3/23/2016 9:00,33576,10810,389,4712,17665,18550,-885
3/23/2016 10:00,34175,10105,487,4712,18870,19541,-671
3/23/2016 11:00,34882,9666,510,4712,19995,20153,-158
3/23/2016 12:00,35491,9209,519,4712,21051,21028,23
3/23/2016 13:00,35986,8864,516,4712,21893,21820,73
3/23/2016 14:00,36757,8443,513,4712,23089,22881,208
3/23/2016 15:00,37404,8348,501,4712,23843,23303,540
3/23/2016 16:00,38021,8224,471,4712,24614,23031,1583
3/23/2016 17:00,38540,9181,371,4712,24277,21771,2506
3/23/2016 18:00,38660,10464,242,4712,23242,20696,2546
3/23/2016 19:00,38451,12065,0,4712,21673,20557,1116
3/23/2016 20:00,38463,12215,0,4712,21536,19977,1559
3/23/2016 21:00,39328,11459,0,4712,23156,17739,5417
3/23/2016 22:00,38032,12091,0,4712,21230,14181,7049
3/23/2016 23:00,35274,12798,0,4712,17764,12277,5487
3/24/2016 0:00,32091,12110,0,4712,15269,11649,3620
3/24/2016 1:00,29774,11500,0,4712,13561,11577,1984
3/24/2016 2:00,28232,10251,0,4712,13269,12591,678
3/24/2016 3:00,27031,8790,0,4712,13529,12749,780
3/24/2016 4:00,26597,10029,0,4712,11856,13639,-1783
3/24/2016 5:00,26914,9690,0,4712,12512,16448,-3936
3/24/2016 6:00,28638,10135,0,4712,13792,19034,-5242
3/24/2016 7:00,32212,8505,1,4712,18994,19731,-737
3/24/2016 8:00,34027,8802,213,4712,20301,18508,1793
3/24/2016 9:00,33742,9722,294,4712,19014,19468,-454
3/24/2016 10:00,34138,7971,310,4712,21145,20896,249
3/24/2016 11:00,34245,6418,444,4712,22671,21940,731
3/24/2016 12:00,34230,5264,512,4712,23741,22606,1135
3/24/2016 13:00,34020,4619,512,4712,24177,23068,1109
3/24/2016 14:00,33884,3993,501,4712,24677,23271,1406
3/24/2016 15:00,33713,3417,479,4712,25105,23901,1204
3/24/2016 16:00,33564,2754,466,4712,25631,24161,1470
3/24/2016 17:00,33570,2180,393,4712,26286,24380,1906
3/24/2016 18:00,33433,1552,258,4712,26910,24789,2121
3/24/2016 19:00,33040,1203,0,4712,27125,26077,1048
3/24/2016 20:00,33071,1853,0,4712,26506,24567,1939
3/24/2016 21:00,34476,3211,0,4712,26553,21802,4751
3/24/2016 22:00,33783,4419,0,4712,24652,18848,5804
3/24/2016 23:00,32079,5598,0,4712,21769,16376,5393
3/25/2016 0:00,29850,6677,0,4712,18461,14845,3616
3/25/2016 1:00,28185,7612,0,4712,15861,13831,2030
3/25/2016 2:00,27372,7785,0,4712,14875,13948,927
3/25/2016 3:00,27023,8141,0,4712,14171,13974,197
3/25/2016 4:00,27086,8857,0,4712,13517,15134,-1617
3/25/2016 5:00,27767,9065,0,4712,13990,16679,-2689
3/25/2016 6:00,29490,10026,0,4712,14752,18259,-3507
3/25/2016 7:00,32099,9736,0,4712,17650,19396,-1746
3/25/2016 8:00,33896,8318,236,4712,20630,20124,506
3/25/2016 9:00,34336,8525,341,4712,20758,19248,1510
3/25/2016 10:00,34305,9022,381,4712,20190,17877,2313
3/25/2016 11:00,33985,9456,392,4712,19424,17205,2219
3/25/2016 12:00,33490,9201,513,4712,19065,16665,2400
3/25/2016 13:00,32999,9151,516,4712,18620,16633,1987
3/25/2016 14:00,32684,9183,508,4712,18281,16600,1681
3/25/2016 15:00,32638,9484,483,4712,17960,16640,1320
3/25/2016 16:00,32766,9743,470,4712,17842,16368,1474
3/25/2016 17:00,32992,10356,392,4712,17532,15456,2076
3/25/2016 18:00,33084,10567,250,4712,17554,15503,2051
3/25/2016 19:00,32542,10294,0,4712,17536,16427,1109
3/25/2016 20:00,32227,11221,0,4712,16294,15183,1111
3/25/2016 21:00,33220,11162,0,4712,17347,14227,3120
3/25/2016 22:00,32491,10791,0,4712,16989,13183,3806
3/25/2016 23:00,31128,10879,0,4712,15537,11476,4061
3/26/2016 0:00,29224,10231,0,4712,14281,10910,3371
3/26/2016 1:00,27511,10499,0,4712,12300,10592,1708
3/26/2016 2:00,26368,10069,0,4712,11588,10644,944
3/26/2016 3:00,25773,10016,0,4712,11045,11004,41
3/26/2016 4:00,25520,9521,0,4712,11288,11905,-617
3/26/2016 5:00,25659,8537,0,4712,12410,13038,-628
3/26/2016 6:00,26314,8817,0,4712,12785,14865,-2080
3/26/2016 7:00,27580,7416,8,4712,15444,17595,-2151
3/26/2016 8:00,28785,5505,272,4712,18296,19524,-1228
3/26/2016 9:00,29969,5241,380,4712,19635,20898,-1263
3/26/2016 10:00,31045,3281,398,4712,22654,22529,125
3/26/2016 11:00,31520,1896,453,4712,24459,23116,1343
3/26/2016 12:00,31691,1061,454,4712,25464,23387,2077
3/26/2016 13:00,31787,1087,418,4712,25571,23709,1862
3/26/2016 14:00,31685,1151,441,4712,25382,24160,1222
3/26/2016 15:00,32023,1436,434,4712,25441,24108,1333
3/26/2016 16:00,32355,1922,431,4712,25290,23806,1484
3/26/2016 17:00,32768,2966,389,4712,24701,22264,2437
3/26/2016 18:00,32950,4548,264,4712,23426,21479,1947
3/26/2016 19:00,32744,5486,0,4712,22547,21603,944
3/26/2016 20:00,32876,6505,0,4712,21659,19508,2151
3/26/2016 21:00,33958,8129,0,4712,21118,16949,4169
3/26/2016 22:00,33296,9170,0,4712,19414,14608,4806
3/26/2016 23:00,31857,10100,0,4712,17045,12148,4897
3/27/2016 0:00,29933,10488,0,4712,14733,11401,3332
3/27/2016 1:00,28062,9113,0,4712,14237,11094,3143
3/27/2016 2:00,26645,9796,0,4712,12137,10164,1973
3/27/2016 3:00,25699,9786,0,4712,11200,10043,1157
3/27/2016 4:00,25207,10092,0,4712,10402,10322,80
3/27/2016 5:00,25124,9595,0,4712,10817,11747,-930
3/27/2016 6:00,25456,8288,0,4712,12456,13971,-1515
3/27/2016 7:00,26304,7534,36,4712,14023,15551,-1528
3/27/2016 8:00,27297,6964,349,4712,15272,17164,-1892
3/27/2016 9:00,28648,6156,466,4712,17315,19376,-2061
3/27/2016 10:00,30242,4995,508,4712,20026,20673,-647
3/27/2016 11:00,31117,3965,525,4712,21914,21703,211
3/27/2016 12:00,31492,3054,529,4712,23196,22128,1068
3/27/2016 13:00,31823,2911,527,4712,23674,22387,1287
3/27/2016 14:00,31913,2509,521,4712,24171,22966,1205
3/27/2016 15:00,31827,2042,503,4712,24571,23617,954
3/27/2016 16:00,31985,1537,459,4712,25277,24198,1079
3/27/2016 17:00,32331,1312,433,4712,25874,24570,1304
3/27/2016 18:00,32593,1013,309,4712,26559,25114,1445
3/27/2016 19:00,32545,879,0,4712,26954,26008,946
3/27/2016 20:00,32721,1507,0,4712,26502,24775,1727
3/27/2016 21:00,34244,2419,0,4712,27113,22170,4943
3/27/2016 22:00,33670,3714,0,4712,25245,18357,6888
3/27/2016 23:00,31495,5106,0,4712,21677,15840,5837
3/28/2016 0:00,28820,5844,0,4712,18264,14467,3797
3/28/2016 1:00,26907,6311,0,4712,15884,13879,2005
3/28/2016 2:00,25943,6657,0,4712,14574,13854,720
3/28/2016 3:00,25563,6697,0,4712,14154,14331,-177
3/28/2016 4:00,25642,7185,0,4712,13744,15989,-2245
3/28/2016 5:00,26477,7563,0,4712,14201,18577,-4376
3/28/2016 6:00,28801,7890,0,4712,16199,20411,-4212
3/28/2016 7:00,32848,7925,63,4712,20148,20063,85
3/28/2016 8:00,34684,6604,406,4712,22963,21339,1624
3/28/2016 9:00,34323,6028,450,4712,23133,21609,1524
3/28/2016 10:00,34267,5999,495,4712,23061,21336,1725
3/28/2016 11:00,34384,6491,518,4712,22664,20928,1736
3/28/2016 12:00,34383,6372,528,4712,22772,21476,1296
3/28/2016 13:00,34322,6893,526,4712,22191,21207,984
3/28/2016 14:00,34727,7102,520,4712,22393,21165,1228
3/28/2016 15:00,35087,7848,502,4712,22025,21006,1019
3/28/2016 16:00,35579,8795,466,4712,21606,20063,1543
3/28/2016 17:00,36149,10058,391,4712,20987,18818,2169
3/28/2016 18:00,36279,10558,258,4712,20752,19049,1703
3/28/2016 19:00,36041,10070,2,4712,21258,20119,1139
3/28/2016 20:00,36117,11401,0,4712,20004,18106,1898
3/28/2016 21:00,37394,12045,0,4712,20637,15344,5293
3/28/2016 22:00,36147,12134,0,4712,19301,13163,6138
3/28/2016 23:00,33448,11310,0,4712,17427,11623,5804
3/29/2016 0:00,30358,10304,0,4712,15342,11405,3937
3/29/2016 1:00,28297,9738,0,4712,13847,11370,2477
3/29/2016 2:00,27038,9628,0,4712,12698,11537,1161
3/29/2016 3:00,26425,9190,0,4712,12523,11783,740
3/29/2016 4:00,26233,9740,0,4712,11780,13274,-1494
3/29/2016 5:00,26823,9833,0,4712,12278,17031,-4753
3/29/2016 6:00,28869,9096,0,4712,15061,19268,-4207
3/29/2016 7:00,32688,8470,73,4712,19433,19710,-277
3/29/2016 8:00,34191,7672,422,4712,21385,19832,1553
3/29/2016 9:00,33854,8620,454,4712,20067,19754,313
3/29/2016 10:00,34299,8820,498,4712,20268,19921,347
3/29/2016 11:00,34890,9284,520,4712,20373,19893,480
3/29/2016 12:00,35269,9091,523,4712,20943,19995,948
3/29/2016 13:00,35415,9368,525,4712,20810,19184,1626
3/29/2016 14:00,35675,10743,518,4712,19702,18046,1656
3/29/2016 15:00,35805,12023,501,4712,18570,17092,1478
3/29/2016 16:00,35996,12618,462,4712,18204,17272,932
3/29/2016 17:00,36200,12273,429,4712,18786,17767,1019
3/29/2016 18:00,36199,12627,278,4712,18583,18259,324
3/29/2016 19:00,36219,12433,1,4712,19074,19067,7
3/29/2016 20:00,36894,12946,0,4712,19236,17720,1516
3/29/2016 21:00,37820,13143,0,4712,19965,15161,4804
3/29/2016 22:00,36664,13316,0,4712,18636,13090,5546
3/29/2016 23:00,34231,12196,0,4712,17323,11775,5548
3/30/2016 0:00,31382,12266,0,4712,14404,10855,3549
3/30/2016 1:00,29329,11981,0,4712,12636,10715,1921
3/30/2016 2:00,28268,11868,0,4712,11688,10618,1070
3/30/2016 3:00,27750,11281,0,4712,11756,11630,126
3/30/2016 4:00,27519,10215,0,4712,12592,14676,-2084
3/30/2016 5:00,27975,9001,0,4712,14262,18481,-4219
3/30/2016 6:00,29796,8725,0,4712,16358,20885,-4527
3/30/2016 7:00,33553,7799,3,4712,21039,21813,-774
3/30/2016 8:00,35467,6700,153,4712,23903,22723,1180
3/30/2016 9:00,35346,6522,213,4712,23898,23603,295
3/30/2016 10:00,35889,5862,235,4712,25080,24637,443
3/30/2016 11:00,36617,5341,296,4712,26268,25057,1211
3/30/2016 12:00,37193,5236,413,4712,26832,25233,1599
3/30/2016 13:00,37520,5693,410,4712,26705,24672,2033
3/30/2016 14:00,37801,6130,400,4712,26560,24827,1733
3/30/2016 15:00,37979,6510,352,4712,26405,25095,1310
3/30/2016 16:00,38191,6678,223,4712,26579,24900,1679
3/30/2016 17:00,38401,7251,188,4712,26250,24082,2168
3/30/2016 18:00,38464,7506,110,4712,26135,24323,1812
3/30/2016 19:00,38239,7053,0,4712,26474,24641,1833
3/30/2016 20:00,38112,7808,0,4712,25592,23293,2299
3/30/2016 21:00,38854,8462,0,4712,25680,20166,5514
3/30/2016 22:00,37737,8563,0,4712,24462,17976,6486
3/30/2016 23:00,35257,7808,0,4712,22737,16369,6368
3/31/2016 0:00,32292,8148,0,4712,19432,14529,4903
3/31/2016 1:00,30145,9437,0,4712,15996,13208,2788
3/31/2016 2:00,28909,9493,0,4712,14704,13131,1573
3/31/2016 3:00,28212,9157,0,4712,14343,13968,375
3/31/2016 4:00,27984,8578,0,4712,14694,16005,-1311
3/31/2016 5:00,28363,7739,0,4712,15912,19550,-3638
3/31/2016 6:00,30128,7565,0,4712,17851,21368,-3517
3/31/2016 7:00,33727,7024,0,4712,21990,22206,-216
3/31/2016 8:00,35163,5960,22,4712,24469,23785,684
3/31/2016 9:00,34998,4732,69,4712,25485,26200,-715
3/31/2016 10:00,35812,2759,108,4712,28234,28120,114
3/31/2016 11:00,36762,1692,198,4712,30160,29235,925
3/31/2016 12:00,37697,982,264,4712,31740,30761,979
3/31/2016 13:00,38690,683,263,4712,33032,31789,1243
3/31/2016 14:00,39922,625,250,4712,34336,32854,1482
3/31/2016 15:00,41032,794,306,4712,35220,33610,1610
3/31/2016 16:00,42276,913,193,4712,36458,33445,3013
3/31/2016 17:00,43126,1623,139,4712,36652,31867,4785
3/31/2016 18:00,43322,2464,59,4712,36087,30587,5500
3/31/2016 19:00,42220,3273,0,4712,34234,28886,5348
3/31/2016 20:00,40948,6482,0,4712,29754,25387,4367
3/31/2016 21:00,41346,8018,0,4712,28616,22162,6454
3/31/2016 22:00,39599,7889,0,4712,26998,19078,7920
3/31/2016 23:00,36437,6634,0,4712,25092,17747,7345
4/1/2016 0:00,32641,5764,0,4712,22165,16979,5186
4/1/2016 1:00,29746,4974,0,4712,20060,16479,3581
4/1/2016 2:00,28073,5330,0,4712,18032,15126,2906
4/1/2016 3:00,27024,6913,0,4712,15400,14224,1176
4/1/2016 4:00,26578,7426,0,4712,14440,15656,-1216
4/1/2016 5:00,26846,7207,0,4712,14926,18849,-3923
4/1/2016 6:00,28422,7220,0,4712,16490,20029,-3539
4/1/2016 7:00,31816,7402,0,4712,19702,19896,-194
4/1/2016 8:00,33325,7451,192,4712,20970,20738,232
4/1/2016 9:00,33282,7092,274,4712,21204,20549,655
4/1/2016 10:00,33850,8347,313,4712,20478,19606,872
4/1/2016 11:00,34488,8845,379,4712,20553,19245,1308
4/1/2016 12:00,34795,8879,445,4712,20758,19467,1291
4/1/2016 13:00,34677,8452,494,4712,21019,19517,1502
4/1/2016 14:00,34506,7991,494,4712,21309,19784,1525
4/1/2016 15:00,34157,7139,481,4712,21824,20539,1285
4/1/2016 16:00,33908,5988,428,4712,22780,21159,1621
4/1/2016 17:00,33570,5284,368,4712,23206,21230,1976
4/1/2016 18:00,33218,4817,239,4712,23451,21573,1878
4/1/2016 19:00,32706,4899,0,4712,23094,22897,197
4/1/2016 20:00,32900,5096,0,4712,23092,21869,1223
4/1/2016 21:00,34030,5255,0,4712,24062,20513,3549
4/1/2016 22:00,33439,5414,0,4712,23313,18770,4543
4/1/2016 23:00,32030,5969,0,4712,21348,16802,4546
4/2/2016 0:00,30074,6559,0,4712,18803,15444,3359
4/2/2016 1:00,28531,7039,0,4712,16780,14756,2024
4/2/2016 2:00,27572,6985,0,4712,15875,14888,987
4/2/2016 3:00,27086,6638,0,4712,15736,15554,182
4/2/2016 4:00,26916,6044,0,4712,16160,16759,-599
4/2/2016 5:00,27198,5724,0,4712,16762,18245,-1483
4/2/2016 6:00,28016,5215,0,4712,18088,20346,-2258
4/2/2016 7:00,29738,4816,22,4712,20189,22035,-1846
4/2/2016 8:00,31181,3432,193,4712,22844,23567,-723
4/2/2016 9:00,32182,2428,281,4712,24761,23986,775
4/2/2016 10:00,32599,2068,420,4712,25399,23472,1927
4/2/2016 11:00,32491,2108,434,4712,25237,23313,1924
4/2/2016 12:00,32001,1677,503,4712,25109,23202,1907
4/2/2016 13:00,31468,1362,509,4712,24885,23222,1663
4/2/2016 14:00,30999,1214,505,4712,24568,23321,1247
4/2/2016 15:00,30719,1151,488,4712,24368,23640,728
4/2/2016 16:00,30751,876,444,4712,24719,23980,739
4/2/2016 17:00,31002,687,417,4712,25186,24315,871
4/2/2016 18:00,31187,346,263,4712,25866,24687,1179
4/2/2016 19:00,31131,300,2,4712,26118,25390,728
4/2/2016 20:00,31244,811,0,4712,25721,24203,1518
4/2/2016 21:00,32375,2040,0,4712,25624,21846,3778
4/2/2016 22:00,31822,3478,0,4712,23633,18545,5088
4/2/2016 23:00,30412,4775,0,4712,20926,15815,5111
4/3/2016 0:00,28665,6076,0,4712,17877,14202,3675
4/3/2016 1:00,27151,6744,0,4712,15695,13493,2202
4/3/2016 2:00,26265,6867,0,4712,14687,13451,1236
4/3/2016 3:00,25789,6588,0,4712,14489,13582,907
4/3/2016 4:00,25657,6690,0,4712,14255,14368,-113
4/3/2016 5:00,25816,6226,0,4712,14878,15379,-501
4/3/2016 6:00,26433,6410,0,4712,15311,16313,-1002
4/3/2016 7:00,27652,6156,5,4712,16778,17933,-1155
4/3/2016 8:00,28686,4801,69,4712,19104,20267,-1163
4/3/2016 9:00,29882,3848,251,4712,21071,19505,1566
4/3/2016 10:00,30500,5748,318,4712,19722,18386,1336
4/3/2016 11:00,30653,5720,410,4712,19811,18884,927
4/3/2016 12:00,30774,5666,476,4712,19920,19086,834
4/3/2016 13:00,30991,5700,512,4712,20067,19695,372
4/3/2016 14:00,31302,5419,508,4712,20662,20575,87
4/3/2016 15:00,31721,5330,458,4712,21221,21549,-328
4/3/2016 16:00,32384,5145,394,4712,22133,22693,-560
4/3/2016 17:00,33209,4592,296,4712,23608,24041,-433
4/3/2016 18:00,33948,3583,112,4712,25541,24856,685
4/3/2016 19:00,34113,2978,1,4712,26423,25348,1075
4/3/2016 20:00,33984,4296,0,4712,24975,23417,1558
4/3/2016 21:00,35124,5789,0,4712,24622,19177,5445
4/3/2016 22:00,34181,8082,0,4712,21387,14948,6439
4/3/2016 23:00,31837,9083,0,4712,18042,12526,5516
4/4/2016 0:00,28965,9642,0,4712,14611,11668,2943
4/4/2016 1:00,26920,9152,0,4712,13056,11635,1421
4/4/2016 2:00,25737,9207,0,4712,11818,11654,164
4/4/2016 3:00,25180,9430,0,4712,11038,12197,-1159
4/4/2016 4:00,25107,9093,0,4712,11302,14291,-2989
4/4/2016 5:00,25741,7678,0,4712,13350,17860,-4510
4/4/2016 6:00,27810,7720,0,4712,15378,19940,-4562
4/4/2016 7:00,31607,6686,0,4712,20209,21091,-882
4/4/2016 8:00,32972,4859,113,4712,23288,23473,-185
4/4/2016 9:00,32901,3158,223,4712,24808,25140,-332
4/4/2016 10:00,33320,2496,241,4712,25871,26764,-893
4/4/2016 11:00,33969,1655,290,4712,27312,27901,-589
4/4/2016 12:00,34594,1145,277,4712,28460,29092,-632
4/4/2016 13:00,35219,1045,271,4712,29191,29949,-758
4/4/2016 14:00,36200,1415,302,4712,29771,30692,-921
4/4/2016 15:00,37383,1713,337,4712,30621,31530,-909
4/4/2016 16:00,38568,1765,182,4712,31909,31970,-61
4/4/2016 17:00,39811,2007,109,4712,32982,31591,1391
4/4/2016 18:00,40465,2614,68,4712,33070,29877,3193
4/4/2016 19:00,40319,3980,0,4712,31627,28404,3223
4/4/2016 20:00,39372,6395,0,4712,28265,24911,3354
4/4/2016 21:00,39759,8377,0,4712,26670,20388,6282
4/4/2016 22:00,38006,8561,0,4712,24732,17167,7565
4/4/2016 23:00,34638,9124,0,4712,20802,14183,6619
4/5/2016 0:00,31087,9719,0,4712,16655,12643,4012
4/5/2016 1:00,28505,9575,0,4712,14218,11764,2454
4/5/2016 2:00,26970,9760,0,4712,12498,11322,1176
4/5/2016 3:00,26033,9812,0,4712,11509,11919,-410
4/5/2016 4:00,25721,9675,0,4712,11334,13687,-2353
4/5/2016 5:00,26176,9599,0,4712,11864,16447,-4583
4/5/2016 6:00,27938,9841,0,4712,13384,17448,-4064
4/5/2016 7:00,31652,9840,36,4712,17063,17793,-730
4/5/2016 8:00,32845,9119,179,4712,18835,18761,74
4/5/2016 9:00,32949,8765,245,4712,19227,20193,-966
4/5/2016 10:00,33774,8440,279,4712,20343,21528,-1185
4/5/2016 11:00,34819,9099,306,4712,20702,22292,-1590
4/5/2016 12:00,35822,8971,333,4712,21806,23333,-1527
4/5/2016 13:00,37001,9400,356,4712,22533,24121,-1588
4/5/2016 14:00,38328,9450,369,4712,23796,25303,-1507
4/5/2016 15:00,39309,9405,359,4712,24832,26057,-1225
4/5/2016 16:00,40436,9329,346,4712,26049,25597,452
4/5/2016 17:00,41260,10013,264,4712,26272,24256,2016
4/5/2016 18:00,41221,10439,203,4712,25868,23202,2666
4/5/2016 19:00,40257,10604,2,4712,24938,23670,1268
4/5/2016 20:00,39250,10606,0,4712,23932,22099,1833
4/5/2016 21:00,39709,10660,0,4712,24337,18673,5664
4/5/2016 22:00,38061,10929,0,4712,22420,15725,6695
4/5/2016 23:00,34829,10765,0,4712,19352,13553,5799
4/6/2016 0:00,31342,10659,0,4712,15971,12570,3401
4/6/2016 1:00,28885,10313,0,4712,13860,12210,1650
4/6/2016 2:00,27456,10076,0,4712,12669,12325,344
4/6/2016 3:00,26630,9163,0,4712,12754,12524,230
4/6/2016 4:00,26281,9952,0,4712,11617,13691,-2074
4/6/2016 5:00,26600,9943,0,4712,11945,17347,-5402
4/6/2016 6:00,28563,9584,0,4712,14267,18639,-4372
4/6/2016 7:00,32125,9067,48,4712,18297,20593,-2296
4/6/2016 8:00,33274,6109,222,4712,22231,22231,0
4/6/2016 9:00,33338,6730,293,4712,21603,22548,-945
4/6/2016 10:00,34016,7048,346,4712,21910,23249,-1339
4/6/2016 11:00,34882,6066,347,4712,23757,25367,-1610
4/6/2016 12:00,35603,4402,381,4712,26109,27304,-1195
4/6/2016 13:00,36182,3833,455,4712,27182,28382,-1200
4/6/2016 14:00,36940,3015,438,4712,28776,29590,-814
4/6/2016 15:00,37615,2783,452,4712,29668,30337,-669
4/6/2016 16:00,38308,2679,438,4712,30479,30803,-324
4/6/2016 17:00,39103,2084,378,4712,31929,31131,798
4/6/2016 18:00,39215,1348,225,4712,32930,31184,1746
4/6/2016 19:00,38744,608,1,4712,33423,31884,1539
4/6/2016 20:00,37903,924,0,4712,32267,29832,2435
4/6/2016 21:00,38416,1939,0,4712,31765,25459,6306
4/6/2016 22:00,36854,3653,0,4712,28489,20231,8258
4/6/2016 23:00,33650,5675,0,4712,23263,16304,6959
4/7/2016 0:00,30334,6846,0,4712,18776,14560,4216
4/7/2016 1:00,28017,7046,0,4712,16259,14050,2209
4/7/2016 2:00,26753,6937,0,4712,15104,13784,1320
4/7/2016 3:00,26013,6939,0,4712,14362,13958,404
4/7/2016 4:00,25678,7697,0,4712,13269,15025,-1756
4/7/2016 5:00,26213,9011,0,4712,12489,18016,-5527
4/7/2016 6:00,28231,8717,0,4712,14801,18997,-4196
4/7/2016 7:00,32107,8657,13,4712,18725,19349,-624
4/7/2016 8:00,33229,7418,218,4712,20880,21513,-633
4/7/2016 9:00,33232,6283,325,4712,21911,22165,-254
4/7/2016 10:00,33868,6462,381,4712,22313,23792,-1479
4/7/2016 11:00,34716,5196,440,4712,24367,25860,-1493
4/7/2016 12:00,35604,4304,453,4712,26135,28180,-2045
4/7/2016 13:00,36514,3725,515,4712,27562,29466,-1904
4/7/2016 14:00,37738,3796,506,4712,28724,30253,-1529
4/7/2016 15:00,38967,4310,502,4712,29443,30322,-879
4/7/2016 16:00,40231,5567,475,4712,29477,28628,849
4/7/2016 17:00,41364,6874,403,4712,29375,27187,2188
4/7/2016 18:00,41541,7607,257,4712,28965,25845,3120
4/7/2016 19:00,40504,8289,1,4712,27502,25649,1853
4/7/2016 20:00,39415,8999,0,4712,25704,23681,2023
4/7/2016 21:00,39860,9309,0,4712,25839,20949,4890
4/7/2016 22:00,38179,8688,0,4712,24779,17746,7033
4/7/2016 23:00,34936,8111,0,4712,22113,15675,6438
4/8/2016 0:00,31434,7961,0,4712,18761,14475,4286
4/8/2016 1:00,28925,7253,0,4712,16961,14112,2849
4/8/2016 2:00,27370,7113,0,4712,15545,14141,1404
4/8/2016 3:00,26434,6702,0,4712,15019,14673,346
4/8/2016 4:00,26104,6211,0,4712,15181,16967,-1786
4/8/2016 5:00,26447,5453,0,4712,16282,20480,-4198
4/8/2016 6:00,28068,5131,0,4712,18225,21833,-3608
4/8/2016 7:00,31479,5193,6,4712,21569,22289,-720
4/8/2016 8:00,32676,4044,33,4712,23887,23738,149
4/8/2016 9:00,32921,3806,54,4712,24350,24676,-326
4/8/2016 10:00,33733,3550,145,4712,25327,25440,-113
4/8/2016 11:00,34645,3346,262,4712,26325,25710,615
4/8/2016 12:00,35172,4043,349,4712,26068,25961,107
4/8/2016 13:00,35750,4534,352,4712,26152,26274,-122
4/8/2016 14:00,36621,4802,331,4712,26776,26394,382
4/8/2016 15:00,37272,4976,347,4712,27237,26388,849
4/8/2016 16:00,37677,5846,330,4712,26789,25742,1047
4/8/2016 17:00,37996,6266,201,4712,26818,24260,2558
4/8/2016 18:00,37682,6555,88,4712,26326,23472,2854
4/8/2016 19:00,36732,5868,1,4712,26150,24262,1888
4/8/2016 20:00,35863,6998,0,4712,24153,22050,2103
4/8/2016 21:00,36389,8168,0,4712,23508,19348,4160
4/8/2016 22:00,35350,8504,0,4712,22134,16483,5651
4/8/2016 23:00,33231,9342,0,4712,19178,14499,4679
4/9/2016 0:00,30822,9403,0,4712,16707,13531,3176
4/9/2016 1:00,28701,9396,0,4712,14593,12472,2121
4/9/2016 2:00,27308,8731,0,4712,13865,12931,934
4/9/2016 3:00,26443,8156,0,4712,13576,13041,535
4/9/2016 4:00,25963,7603,0,4712,13649,15145,-1496
4/9/2016 5:00,25795,5533,0,4712,15550,17215,-1665
4/9/2016 6:00,26176,5278,0,4712,16186,17511,-1325
4/9/2016 7:00,27363,6044,14,4712,16593,18550,-1957
4/9/2016 8:00,28402,6276,212,4712,17201,19262,-2061
4/9/2016 9:00,29826,6430,371,4712,18312,19897,-1585
4/9/2016 10:00,31341,7650,385,4712,18594,19246,-652
4/9/2016 11:00,32483,8748,395,4712,18628,19250,-622
4/9/2016 12:00,33261,8514,400,4712,19635,19553,82
4/9/2016 13:00,33484,8470,450,4712,19852,19596,256
4/9/2016 14:00,33635,8933,404,4712,19587,19344,243
4/9/2016 15:00,33828,9301,364,4712,19451,19057,394
4/9/2016 16:00,34030,9506,314,4712,19498,18759,739
4/9/2016 17:00,34087,9744,132,4712,19498,18282,1216
4/9/2016 18:00,34026,10018,78,4712,19218,18247,971
4/9/2016 19:00,33808,9873,0,4712,19222,19471,-249
4/9/2016 20:00,33708,10437,0,4712,18559,17498,1061
4/9/2016 21:00,34645,11670,0,4712,18263,15296,2967
4/9/2016 22:00,33982,12670,0,4712,16600,13323,3277
4/9/2016 23:00,32540,12743,0,4712,15085,11790,3295
4/10/2016 0:00,30603,12296,0,4712,13595,10582,3013
4/10/2016 1:00,28840,12165,0,4712,11963,10143,1820
4/10/2016 2:00,27557,12123,0,4712,10723,9965,758
4/10/2016 3:00,26728,11857,0,4712,10159,9824,335
4/10/2016 4:00,26265,11804,0,4712,9749,10103,-354
4/10/2016 5:00,26140,11824,0,4712,9604,10876,-1272
4/10/2016 6:00,26385,11712,0,4712,9961,11696,-1735
4/10/2016 7:00,27125,11176,21,4712,11217,13448,-2231
4/10/2016 8:00,27657,10896,149,4712,11900,15170,-3270
4/10/2016 9:00,29214,10626,223,4712,13653,16420,-2767
4/10/2016 10:00,31039,10213,311,4712,15803,18119,-2316
4/10/2016 11:00,32420,9584,308,4712,17817,18967,-1150
4/10/2016 12:00,33468,10103,401,4712,18252,18982,-730
4/10/2016 13:00,34417,10835,390,4712,18480,19351,-871
4/10/2016 14:00,35192,10511,305,4712,19664,20005,-341
4/10/2016 15:00,35874,10426,315,4712,20421,20254,167
4/10/2016 16:00,36300,11078,303,4712,20207,20326,-119
4/10/2016 17:00,36716,10920,203,4712,20881,20119,762
4/10/2016 18:00,36985,11445,104,4712,20724,20916,-192
4/10/2016 19:00,36986,10610,6,4712,21658,22223,-565
4/10/2016 20:00,37347,11744,0,4712,20891,21441,-550
4/10/2016 21:00,38593,11239,0,4712,22642,19527,3115
4/10/2016 22:00,37882,11097,0,4712,22073,16890,5183
4/10/2016 23:00,35488,10603,0,4712,20173,15652,4521
4/11/2016 0:00,32574,9015,0,4712,18846,15820,3026
4/11/2016 1:00,30315,7838,0,4712,17765,16309,1456
4/11/2016 2:00,28919,6739,0,4712,17468,16312,1156
4/11/2016 3:00,28099,7107,0,4712,16279,16384,-105
4/11/2016 4:00,27911,7031,0,4712,16167,17910,-1743
4/11/2016 5:00,28488,7117,0,4712,16659,21092,-4433
4/11/2016 6:00,30378,7514,0,4712,18152,22584,-4432
4/11/2016 7:00,33864,7447,19,4712,21686,23816,-2130
4/11/2016 8:00,35445,6250,98,4712,24385,24843,-458
4/11/2016 9:00,35763,7101,129,4712,23821,24999,-1178
4/11/2016 10:00,36698,7862,155,4712,23970,25759,-1789
4/11/2016 11:00,37939,7853,270,4712,25104,26824,-1720
4/11/2016 12:00,39265,7656,355,4712,26543,27317,-774
4/11/2016 13:00,40366,7670,448,4712,27536,27738,-202
4/11/2016 14:00,41465,8025,460,4712,28268,28671,-403
4/11/2016 15:00,42525,7646,372,4712,29795,29687,108
4/11/2016 16:00,43541,7776,389,4712,30665,29799,866
4/11/2016 17:00,44159,7398,334,4712,31714,29014,2700
4/11/2016 18:00,43898,7440,220,4712,31525,27168,4357
4/11/2016 19:00,42802,9467,4,4712,28620,27199,1421
4/11/2016 20:00,41830,8910,0,4712,28208,26120,2088
4/11/2016 21:00,42213,8579,0,4712,28922,23472,5450
4/11/2016 22:00,40589,7697,0,4712,28180,21027,7153
4/11/2016 23:00,37173,7012,0,4712,25450,19460,5990
4/12/2016 0:00,33652,6449,0,4712,22491,18364,4127
4/12/2016 1:00,31221,5643,0,4712,20866,18367,2499
4/12/2016 2:00,29707,4129,0,4712,20866,19458,1408
4/12/2016 3:00,28728,3024,0,4712,20992,20417,575
4/12/2016 4:00,28239,2623,0,4712,20903,22438,-1535
4/12/2016 5:00,28474,2400,0,4712,21362,25819,-4457
4/12/2016 6:00,30195,2534,0,4712,22949,26846,-3897
4/12/2016 7:00,33705,2324,89,4712,26580,27085,-505
4/12/2016 8:00,34844,1926,153,4712,28053,27826,227
4/12/2016 9:00,34875,1728,204,4712,28230,29119,-889
4/12/2016 10:00,35437,1101,263,4712,29362,29806,-444
4/12/2016 11:00,36199,1435,297,4712,29755,29847,-92
4/12/2016 12:00,36815,1873,283,4712,29947,29828,119
4/12/2016 13:00,37376,2733,372,4712,29560,29933,-373
4/12/2016 14:00,37879,2650,348,4712,30168,29828,340
4/12/2016 15:00,37911,2570,351,4712,30279,29644,635
4/12/2016 16:00,37885,3074,221,4712,29878,29129,749
4/12/2016 17:00,38102,3389,169,4712,29832,28989,843
4/12/2016 18:00,38006,3559,88,4712,29647,29277,370
4/12/2016 19:00,37631,3114,44,4712,29761,29917,-156
4/12/2016 20:00,37784,3116,0,4712,29956,29132,824
4/12/2016 21:00,38554,2997,0,4712,30845,26982,3863
4/12/2016 22:00,37322,2205,0,4712,30405,23876,6529
4/12/2016 23:00,34612,2790,0,4712,27110,21690,5420
4/13/2016 0:00,31417,1685,0,4712,25020,21343,3677
4/13/2016 1:00,29334,876,0,4712,23746,21095,2651
4/13/2016 2:00,28040,595,0,4712,22733,20971,1762
4/13/2016 3:00,27132,444,0,4712,21975,21306,669
4/13/2016 4:00,26763,603,0,4712,21447,23290,-1843
4/13/2016 5:00,27083,684,0,4712,21687,26722,-5035
4/13/2016 6:00,28834,902,0,4712,23220,27885,-4665
4/13/2016 7:00,32365,1257,81,4712,26316,27733,-1417
4/13/2016 8:00,33783,1287,276,4712,27508,27961,-453
4/13/2016 9:00,33812,1397,385,4712,27317,28236,-919
4/13/2016 10:00,34334,1500,429,4712,27693,28544,-851
4/13/2016 11:00,34902,1445,503,4712,28241,28840,-599
4/13/2016 12:00,35233,1353,515,4712,28653,29073,-420
4/13/2016 13:00,35291,953,503,4712,29124,29462,-338
4/13/2016 14:00,35580,786,490,4712,29592,29699,-107
4/13/2016 15:00,35615,648,455,4712,29800,29903,-103
4/13/2016 16:00,35735,570,409,4712,30044,30047,-3
4/13/2016 17:00,35980,561,338,4712,30369,29667,702
4/13/2016 18:00,36121,743,142,4712,30523,29597,926
4/13/2016 19:00,36041,1176,3,4712,30150,29859,291
4/13/2016 20:00,36160,2088,0,4712,29360,27904,1456
4/13/2016 21:00,37092,3496,0,4712,28885,24206,4679
4/13/2016 22:00,36100,4142,0,4712,27247,20353,6894
4/13/2016 23:00,33505,4512,0,4712,24282,17668,6614
4/14/2016 0:00,30409,5113,0,4712,20584,16206,4378
4/14/2016 1:00,28295,5012,0,4712,18572,15791,2781
4/14/2016 2:00,27038,4753,0,4712,17573,16093,1480
4/14/2016 3:00,26396,4466,0,4712,17218,17030,188
4/14/2016 4:00,26144,3665,0,4712,17767,19239,-1472
4/14/2016 5:00,26572,3399,0,4712,18461,23399,-4938
4/14/2016 6:00,28461,3115,0,4712,20635,24664,-4029
4/14/2016 7:00,32061,3160,35,4712,24153,25087,-934
4/14/2016 8:00,33427,2340,117,4712,26258,26120,138
4/14/2016 9:00,33532,2356,183,4712,26280,26989,-709
4/14/2016 10:00,34169,2252,321,4712,26884,27633,-749
4/14/2016 11:00,35017,2409,395,4712,27501,28168,-667
4/14/2016 12:00,35785,2562,495,4712,28016,28628,-612
4/14/2016 13:00,36473,2871,455,4712,28435,28904,-469
4/14/2016 14:00,37323,3069,506,4712,29037,29526,-489
4/14/2016 15:00,38108,3357,490,4712,29549,29707,-158
4/14/2016 16:00,38848,3821,450,4712,29866,29466,400
4/14/2016 17:00,39548,4717,377,4712,29742,27870,1872
4/14/2016 18:00,39615,5660,313,4712,28930,26579,2351
4/14/2016 19:00,38941,6259,50,4712,27919,26377,1542
4/14/2016 20:00,38126,7958,0,4712,25456,23771,1685
4/14/2016 21:00,38867,9436,0,4712,24719,19846,4873
4/14/2016 22:00,37833,10268,0,4712,22852,15941,6911
4/14/2016 23:00,34941,10774,0,4712,19455,13243,6212
4/15/2016 0:00,31677,10857,0,4712,16108,11826,4282
4/15/2016 1:00,29244,10669,0,4712,13863,11307,2556
4/15/2016 2:00,27715,10544,0,4712,12460,11381,1079
4/15/2016 3:00,26850,10377,0,4712,11761,12057,-296
4/15/2016 4:00,26594,9795,0,4712,12087,14390,-2303
4/15/2016 5:00,26919,9625,0,4712,12582,16842,-4260
4/15/2016 6:00,28653,9903,0,4712,14038,17721,-3683
4/15/2016 7:00,32024,9622,202,4712,17487,18146,-659
4/15/2016 8:00,33041,9490,403,4712,18436,18197,239
4/15/2016 9:00,33309,10379,479,4712,17739,18899,-1160
4/15/2016 10:00,34293,10359,507,4712,18715,20064,-1349
4/15/2016 11:00,35310,10106,511,4712,19981,21146,-1165
4/15/2016 12:00,36070,10086,522,4712,20751,21982,-1231
4/15/2016 13:00,36872,10556,520,4712,21084,22847,-1763
4/15/2016 14:00,37991,10985,514,4712,21781,23668,-1887
4/15/2016 15:00,39078,10929,491,4712,22946,23868,-922
4/15/2016 16:00,39968,10952,476,4712,23828,23563,265
4/15/2016 17:00,40716,11648,421,4712,23934,22372,1562
4/15/2016 18:00,40611,11332,307,4712,24260,21498,2762
4/15/2016 19:00,39520,11276,35,4712,23496,21677,1819
4/15/2016 20:00,38217,11257,0,4712,22249,20470,1779
4/15/2016 21:00,38434,11896,0,4712,21826,17974,3852
4/15/2016 22:00,37353,11987,0,4712,20654,15320,5334
4/15/2016 23:00,35297,12059,0,4712,18526,13020,5506
4/16/2016 0:00,32678,12382,0,4712,15585,11823,3762
4/16/2016 1:00,30394,11675,0,4712,14007,11080,2927
4/16/2016 2:00,28792,12165,0,4712,11916,10641,1275
4/16/2016 3:00,27792,11932,0,4712,11148,10953,195
4/16/2016 4:00,27280,11503,0,4712,11065,11913,-848
4/16/2016 5:00,27175,10564,0,4712,11899,13362,-1463
4/16/2016 6:00,27707,10759,0,4712,12236,13975,-1739
4/16/2016 7:00,28859,10502,122,4712,13523,15725,-2202
4/16/2016 8:00,29882,10436,228,4712,14506,17424,-2918
4/16/2016 9:00,31584,10483,288,4712,16101,18784,-2683
4/16/2016 10:00,33484,10607,361,4712,17804,20200,-2396
4/16/2016 11:00,34971,9845,362,4712,20052,21324,-1272
4/16/2016 12:00,36073,9772,387,4712,21202,21637,-435
4/16/2016 13:00,36697,9922,439,4712,21624,21408,216
4/16/2016 14:00,37122,10576,505,4712,21329,21236,93
4/16/2016 15:00,37432,10447,494,4712,21779,21055,724
4/16/2016 16:00,37661,11367,418,4712,21163,20838,325
4/16/2016 17:00,37718,11169,358,4712,21479,20789,690
4/16/2016 18:00,37588,10216,266,4712,22393,21150,1243
4/16/2016 19:00,37065,9396,90,4712,22867,23089,-222
4/16/2016 20:00,36792,8385,0,4712,23695,23084,611
4/16/2016 21:00,37198,7170,0,4712,25317,22995,2322
4/16/2016 22:00,36527,5738,0,4712,26077,21715,4362
4/16/2016 23:00,34930,5608,0,4712,24610,19528,5082
4/17/2016 0:00,32842,6622,0,4712,21507,17863,3644
4/17/2016 1:00,30846,6537,0,4712,19596,17430,2166
4/17/2016 2:00,29427,5577,0,4712,19137,17297,1840
4/17/2016 3:00,28453,5189,0,4712,18552,17272,1280
4/17/2016 4:00,27814,4962,0,4712,18140,17200,940
4/17/2016 5:00,27616,4615,0,4712,18289,18586,-297
4/17/2016 6:00,27721,3742,0,4712,19267,19998,-731
4/17/2016 7:00,28349,3699,64,4712,19874,20746,-872
4/17/2016 8:00,28949,4310,242,4712,19686,21997,-2311
4/17/2016 9:00,30394,4561,235,4712,20886,23546,-2660
4/17/2016 10:00,32206,5071,289,4712,22134,24785,-2651
4/17/2016 11:00,33744,4570,393,4712,24070,25976,-1906
4/17/2016 12:00,34897,4241,316,4712,25628,26784,-1156
4/17/2016 13:00,35825,3906,344,4712,26863,26827,36
4/17/2016 14:00,36208,4101,367,4712,27028,26903,125
4/17/2016 15:00,36406,4003,251,4712,27440,27059,381
4/17/2016 16:00,36442,4224,183,4712,27323,26642,681
4/17/2016 17:00,36414,4888,160,4712,26654,26650,4
4/17/2016 18:00,36546,4787,110,4712,26937,26732,205
4/17/2016 19:00,36600,4939,5,4712,26944,27170,-226
4/17/2016 20:00,37020,4957,0,4712,27351,26414,937
4/17/2016 21:00,37587,5012,0,4712,27863,24059,3804
4/17/2016 22:00,36796,5518,0,4712,26566,20591,5975
4/17/2016 23:00,34566,6535,0,4712,23319,17258,6061
4/18/2016 0:00,31892,7365,0,4712,19815,15289,4526
4/18/2016 1:00,29751,8021,0,4712,17018,14673,2345
4/18/2016 2:00,28436,7688,0,4712,16036,14437,1599
4/18/2016 3:00,27805,8001,0,4712,15092,14900,192
4/18/2016 4:00,27643,7389,0,4712,15542,15994,-452
4/18/2016 5:00,28055,8137,0,4712,15206,18071,-2865
4/18/2016 6:00,29495,8434,0,4712,16349,19910,-3561
4/18/2016 7:00,32214,7505,143,4712,19854,20709,-855
4/18/2016 8:00,33375,7375,249,4712,21039,21498,-459
4/18/2016 9:00,33640,5952,327,4712,22649,23697,-1048
4/18/2016 10:00,34400,4872,365,4712,24452,25129,-677
4/18/2016 11:00,35133,3207,482,4712,26732,26149,583
4/18/2016 12:00,35649,2668,502,4712,27766,26477,1289
4/18/2016 13:00,35901,2657,511,4712,28021,27242,779
4/18/2016 14:00,36204,2296,497,4712,28699,27826,873
4/18/2016 15:00,36420,2892,441,4712,28375,27479,896
4/18/2016 16:00,36697,3222,424,4712,28338,27619,719
4/18/2016 17:00,36945,3301,391,4712,28540,27334,1206
4/18/2016 18:00,36970,3040,291,4712,28927,27716,1211
4/18/2016 19:00,36756,2663,46,4712,29335,28347,988
4/18/2016 20:00,36610,3183,0,4712,28715,26875,1840
4/18/2016 21:00,37546,3342,0,4712,29492,24637,4855
4/18/2016 22:00,36520,2916,0,4712,28893,22977,5916
4/18/2016 23:00,33882,2424,0,4712,26746,20709,6037
4/19/2016 0:00,30910,2678,0,4712,23520,19894,3626
4/19/2016 1:00,28830,1574,0,4712,22544,19816,2728
4/19/2016 2:00,27587,1482,0,4712,21393,19603,1790
4/19/2016 3:00,26846,918,0,4712,21216,20496,720
4/19/2016 4:00,26533,728,0,4712,21093,22037,-944
4/19/2016 5:00,26869,781,0,4712,21376,25292,-3916
4/19/2016 6:00,28543,1160,0,4712,22671,26081,-3410
4/19/2016 7:00,31892,1458,175,4712,25547,26623,-1076
4/19/2016 8:00,33237,1380,230,4712,26915,27386,-471
4/19/2016 9:00,33766,1107,296,4712,27652,28798,-1146
4/19/2016 10:00,34735,965,373,4712,28685,29523,-838
4/19/2016 11:00,35931,916,446,4712,29858,30505,-647
4/19/2016 12:00,37013,943,532,4712,30826,30943,-117
4/19/2016 13:00,37965,1709,530,4712,31014,31042,-28
4/19/2016 14:00,39175,2408,531,4712,31525,31643,-118
4/19/2016 15:00,40103,2358,502,4712,32530,32311,219
4/19/2016 16:00,40882,2360,486,4712,33323,32009,1314
4/19/2016 17:00,41630,2897,418,4712,33603,30769,2834
4/19/2016 18:00,41801,3583,293,4712,33214,29274,3940
4/19/2016 19:00,41020,4113,116,4712,32079,29895,2184
4/19/2016 20:00,40153,4743,0,4712,30698,28353,2345
4/19/2016 21:00,40710,4326,0,4712,31672,25819,5853
4/19/2016 22:00,39405,4208,0,4712,30485,23317,7168
4/19/2016 23:00,36408,3389,0,4712,28307,21850,6457
4/20/2016 0:00,33078,3277,0,4712,25089,20376,4713
4/20/2016 1:00,30529,2995,0,4712,22822,19808,3014
4/20/2016 2:00,28971,2547,0,4712,21711,19743,1968
4/20/2016 3:00,28029,1948,0,4712,21370,20509,861
4/20/2016 4:00,27552,1432,0,4712,21408,22931,-1523
4/20/2016 5:00,27824,890,0,4712,22221,26188,-3967
4/20/2016 6:00,29533,868,0,4712,23952,27580,-3628
4/20/2016 7:00,32851,882,111,4712,27145,27434,-289
4/20/2016 8:00,34175,923,286,4712,28254,28055,199
4/20/2016 9:00,34444,1123,388,4712,28221,28946,-725
4/20/2016 10:00,35353,842,430,4712,29369,29294,75
4/20/2016 11:00,36326,603,443,4712,30568,29761,807
4/20/2016 12:00,36758,749,472,4712,30826,30291,535
4/20/2016 13:00,37136,893,472,4712,31059,30896,163
4/20/2016 14:00,37943,1018,436,4712,31777,31447,330
4/20/2016 15:00,38946,1162,379,4712,32694,32196,498
4/20/2016 16:00,39937,1346,291,4712,33588,32271,1317
4/20/2016 17:00,41101,1634,225,4712,34530,31673,2857
4/20/2016 18:00,41572,2729,152,4712,33979,29905,4074
4/20/2016 19:00,41145,3022,42,4712,33368,29646,3722
4/20/2016 20:00,40073,4486,0,4712,30875,26964,3911
4/20/2016 21:00,40386,6584,0,4712,29090,23620,5470
4/20/2016 22:00,39111,7137,0,4712,27263,20177,7086
4/20/2016 23:00,36248,6733,0,4712,24804,17838,6966
4/21/2016 0:00,32845,6376,0,4712,21757,16963,4794
4/21/2016 1:00,30316,6295,0,4712,19309,17009,2300
4/21/2016 2:00,28789,4656,0,4712,19421,17921,1500
4/21/2016 3:00,27827,3897,0,4712,19218,18585,633
4/21/2016 4:00,27404,3474,0,4712,19218,20528,-1310
4/21/2016 5:00,27695,3096,0,4712,19887,24959,-5072
4/21/2016 6:00,29501,2407,0,4712,22382,26072,-3690
4/21/2016 7:00,32776,2230,171,4712,25663,26717,-1054
4/21/2016 8:00,34000,2101,345,4712,26841,27306,-465
4/21/2016 9:00,34473,2180,349,4712,27232,27945,-713
4/21/2016 10:00,35384,1865,403,4712,28404,28151,253
4/21/2016 11:00,36088,1885,392,4712,29099,28066,1033
4/21/2016 12:00,36316,2466,444,4712,28693,28307,386
4/21/2016 13:00,36609,2649,322,4712,28926,29458,-532
4/21/2016 14:00,37523,2820,359,4712,29632,30113,-481
4/21/2016 15:00,38544,3051,338,4712,30443,30559,-116
4/21/2016 16:00,39501,2768,349,4712,31672,31434,238
4/21/2016 17:00,40358,2805,311,4712,32530,31119,1411
4/21/2016 18:00,40797,2510,281,4712,33294,30641,2653
4/21/2016 19:00,40295,1791,51,4712,33741,31200,2541
4/21/2016 20:00,39184,1863,0,4712,32609,30347,2262
4/21/2016 21:00,39541,1673,0,4712,33157,27945,5212
4/21/2016 22:00,38355,1479,0,4712,32164,25011,7153
4/21/2016 23:00,35363,1360,0,4712,29291,22581,6710
4/22/2016 0:00,32017,1293,0,4712,26012,21024,4988
4/22/2016 1:00,29539,1425,0,4712,23402,20044,3358
4/22/2016 2:00,27929,1322,0,4712,21895,19728,2167
4/22/2016 3:00,26978,1058,0,4712,21208,20069,1139
4/22/2016 4:00,26458,954,0,4712,20792,21667,-875
4/22/2016 5:00,26714,871,0,4712,21131,24607,-3476
4/22/2016 6:00,28306,782,0,4712,22812,25794,-2982
4/22/2016 7:00,31272,621,71,4712,25869,26773,-904
4/22/2016 8:00,32441,413,200,4712,27116,28452,-1336
4/22/2016 9:00,33372,326,287,4712,28047,29934,-1887
4/22/2016 10:00,34814,458,324,4712,29320,31106,-1786
4/22/2016 11:00,36523,480,347,4712,30983,31958,-975
4/22/2016 12:00,37967,521,352,4712,32382,32978,-596
4/22/2016 13:00,39264,729,335,4712,33488,33741,-253
4/22/2016 14:00,40557,830,288,4712,34728,34530,198
4/22/2016 15:00,41802,1010,239,4712,35842,35048,794
4/22/2016 16:00,42899,1335,190,4712,36662,34475,2187
4/22/2016 17:00,43632,1825,105,4712,36991,33458,3533
4/22/2016 18:00,43435,2049,45,4712,36629,31586,5043
4/22/2016 19:00,42141,2356,7,4712,35066,29877,5189
4/22/2016 20:00,40086,3804,0,4712,31570,27419,4151
4/22/2016 21:00,39329,5006,0,4712,29610,24656,4954
4/22/2016 22:00,37816,5063,0,4712,28040,21608,6432
4/22/2016 23:00,35281,5208,0,4712,25361,19155,6206
4/23/2016 0:00,32359,5313,0,4712,22333,17406,4927
4/23/2016 1:00,29866,5743,0,4712,19412,15592,3820
4/23/2016 2:00,28077,6194,0,4712,17171,14645,2526
4/23/2016 3:00,26912,6782,0,4712,15418,14099,1319
4/23/2016 4:00,26247,7132,0,4712,14403,14293,110
4/23/2016 5:00,26074,7727,0,4712,13635,14665,-1030
4/23/2016 6:00,26502,7673,0,4712,14117,15528,-1411
4/23/2016 7:00,27363,7379,4,4712,15269,18336,-3067
4/23/2016 8:00,28182,6009,49,4712,17412,20400,-2988
4/23/2016 9:00,30230,6801,87,4712,18630,20992,-2362
4/23/2016 10:00,32350,7489,159,4712,19990,22453,-2463
4/23/2016 11:00,34384,7207,196,4712,22270,23860,-1590
4/23/2016 12:00,36007,6926,321,4712,24047,25536,-1489
4/23/2016 13:00,37425,6718,363,4712,25632,26846,-1214
4/23/2016 14:00,38804,6879,322,4712,26892,27939,-1047
4/23/2016 15:00,40194,6327,241,4712,28913,28520,393
4/23/2016 16:00,41358,6500,192,4712,29954,28357,1597
4/23/2016 17:00,42068,7043,122,4712,30191,26494,3697
4/23/2016 18:00,42012,8027,59,4712,29214,24185,5029
4/23/2016 19:00,40893,8726,0,4712,27455,22941,4514
4/23/2016 20:00,38976,9406,0,4712,24858,21420,3438
4/23/2016 21:00,38548,10060,0,4712,23777,19054,4723
4/23/2016 22:00,37216,10666,0,4712,21838,16739,5099
4/23/2016 23:00,34996,10534,0,4712,19750,14752,4998
4/24/2016 0:00,32455,10577,0,4712,17165,13169,3996
4/24/2016 1:00,30135,9863,0,4712,15560,12677,2883
4/24/2016 2:00,28403,9310,0,4712,14381,12524,1857
4/24/2016 3:00,27245,8676,0,4712,13856,12669,1187
4/24/2016 4:00,26502,8481,0,4712,13309,12738,571
4/24/2016 5:00,26165,8563,0,4712,12890,12890,0
4/24/2016 6:00,26235,8491,0,4712,13032,13406,-374
4/24/2016 7:00,26651,8502,5,4712,13432,15483,-2051
4/24/2016 8:00,27051,7910,54,4712,14375,16693,-2318
4/24/2016 9:00,28912,8696,128,4712,15376,17863,-2487
4/24/2016 10:00,30971,8636,199,4712,17424,19338,-1914
4/24/2016 11:00,32647,8449,273,4712,19212,20695,-1483
4/24/2016 12:00,34064,7778,391,4712,21183,22057,-874
4/24/2016 13:00,35229,7594,420,4712,22503,22911,-408
4/24/2016 14:00,36039,7318,445,4712,23564,23308,256
4/24/2016 15:00,36643,7867,456,4712,23607,23180,427
4/24/2016 16:00,37176,8468,407,4712,23589,23560,29
4/24/2016 17:00,37734,8858,298,4712,23866,23128,738
4/24/2016 18:00,38430,9219,204,4712,24295,22941,1354
4/24/2016 19:00,38518,8399,48,4712,25359,23909,1450
4/24/2016 20:00,38014,9486,0,4712,23817,22562,1255
4/24/2016 21:00,38737,9832,0,4712,24194,20132,4062
4/24/2016 22:00,38262,10288,0,4712,23263,16866,6397
4/24/2016 23:00,35801,11033,0,4712,20056,15027,5029
4/25/2016 0:00,32775,10587,0,4712,17477,13995,3482
4/25/2016 1:00,30512,10154,0,4712,15647,13696,1951
4/25/2016 2:00,29108,9896,0,4712,14501,13831,670
4/25/2016 3:00,28302,9652,0,4712,13938,14404,-466
4/25/2016 4:00,28061,9473,0,4712,13877,16458,-2581
4/25/2016 5:00,28550,8818,0,4712,15020,19659,-4639
4/25/2016 6:00,30513,9195,0,4712,16606,21032,-4426
4/25/2016 7:00,34004,8040,204,4712,21048,23580,-2532
4/25/2016 8:00,35275,6678,397,4712,23488,25675,-2187
4/25/2016 9:00,36092,5913,488,4712,24979,28685,-3706
4/25/2016 10:00,37605,4789,500,4712,27603,31828,-4225
4/25/2016 11:00,39562,3776,529,4712,30545,34019,-3474
4/25/2016 12:00,41672,3535,538,4712,32886,35453,-2567
4/25/2016 13:00,43786,4146,539,4712,34390,36937,-2547
4/25/2016 14:00,46111,4793,538,4712,36068,37025,-957
4/25/2016 15:00,48114,6271,529,4712,36602,36950,-348
4/25/2016 16:00,49640,6925,500,4712,37503,36895,608
4/25/2016 17:00,50842,7238,432,4712,38460,35226,3234
4/25/2016 18:00,50920,7692,298,4712,38218,33472,4746
4/25/2016 19:00,49649,8037,55,4712,36845,32531,4314
4/25/2016 20:00,47842,9039,0,4712,34091,30150,3941
4/25/2016 21:00,47544,9387,0,4712,33445,26022,7423
4/25/2016 22:00,45816,11134,0,4712,29969,21245,8724
4/25/2016 23:00,42238,11659,0,4712,25867,19193,6674
4/26/2016 0:00,38355,10823,0,4712,22820,17773,5047
4/26/2016 1:00,35317,11226,0,4712,19379,16425,2954
4/26/2016 2:00,33489,11475,0,4712,17302,15739,1563
4/26/2016 3:00,32344,11494,0,4712,16138,16089,49
4/26/2016 4:00,31667,10844,0,4712,16110,18833,-2723
4/26/2016 5:00,31823,9333,0,4712,17779,22555,-4776
4/26/2016 6:00,33379,8334,0,4712,20333,24509,-4176
4/26/2016 7:00,36662,7014,140,4712,24796,26434,-1638
4/26/2016 8:00,37644,6661,245,4712,26025,27157,-1132
4/26/2016 9:00,38179,7184,314,4712,25970,28944,-2974
4/26/2016 10:00,39468,6447,327,4712,27981,31604,-3623
4/26/2016 11:00,41098,5364,392,4712,30630,33026,-2396
4/26/2016 12:00,42793,5641,455,4712,31986,33585,-1599
4/26/2016 13:00,44367,6904,460,4712,32291,34415,-2124
4/26/2016 14:00,46088,7714,507,4712,33155,34570,-1415
4/26/2016 15:00,47744,8157,503,4712,34371,34997,-626
4/26/2016 16:00,48964,8053,470,4712,35729,34796,933
4/26/2016 17:00,49657,7987,406,4712,36551,34048,2503
4/26/2016 18:00,49162,7991,276,4712,36183,32437,3746
4/26/2016 19:00,47612,7854,84,4712,34962,33249,1713
4/26/2016 20:00,46327,7281,0,4712,34334,31265,3069
4/26/2016 21:00,46381,7485,0,4712,34184,27568,6616
4/26/2016 22:00,44656,7614,0,4712,32329,23397,8932
4/26/2016 23:00,40442,8274,0,4712,27455,21446,6009
4/27/2016 0:00,36465,6643,0,4712,25110,20254,4856
4/27/2016 1:00,33761,7339,0,4712,21710,18064,3646
4/27/2016 2:00,32029,7969,0,4712,19348,16781,2567
4/27/2016 3:00,30787,8376,0,4712,17699,17127,572
4/27/2016 4:00,29811,7285,0,4712,17814,19094,-1280
4/27/2016 5:00,29810,6659,0,4712,18440,21540,-3100
4/27/2016 6:00,30677,6617,0,4712,19347,22350,-3003
4/27/2016 7:00,33311,5426,174,4712,22999,24101,-1102
4/27/2016 8:00,33976,3977,355,4712,24932,26086,-1154
4/27/2016 9:00,34551,3813,422,4712,25604,28418,-2814
4/27/2016 10:00,36115,3287,505,4712,27612,30539,-2927
4/27/2016 11:00,38107,2972,515,4712,29908,32246,-2338
4/27/2016 12:00,40048,3058,528,4712,31750,34510,-2760
4/27/2016 13:00,41983,2599,531,4712,34141,36609,-2468
4/27/2016 14:00,44033,1901,467,4712,36953,38554,-1601
4/27/2016 15:00,45807,1553,491,4712,39052,40095,-1043
4/27/2016 16:00,47459,1360,460,4712,40927,40502,425
4/27/2016 17:00,48725,1128,446,4712,42439,39614,2825
4/27/2016 18:00,48979,1169,335,4712,42763,38190,4573
4/27/2016 19:00,47912,1929,100,4712,41171,36102,5069
4/27/2016 20:00,45769,3899,0,4712,37159,32657,4502
4/27/2016 21:00,44684,5590,0,4712,34382,27433,6949
4/27/2016 22:00,42711,7157,0,4712,30842,22101,8741
4/27/2016 23:00,38864,8125,0,4712,26027,18799,7228
4/28/2016 0:00,34962,8949,0,4712,21301,17073,4228
4/28/2016 1:00,32084,8618,0,4712,18754,16364,2390
4/28/2016 2:00,30290,8065,0,4712,17513,16119,1394
4/28/2016 3:00,29128,8113,0,4712,16303,16110,193
4/28/2016 4:00,28543,8315,0,4712,15516,17688,-2172
4/28/2016 5:00,28732,8544,0,4712,15476,20207,-4731
4/28/2016 6:00,30515,8807,0,4712,16996,21317,-4321
4/28/2016 7:00,33862,8537,192,4712,20421,23140,-2719
4/28/2016 8:00,35004,7502,297,4712,22493,24431,-1938
4/28/2016 9:00,36042,8651,400,4712,22279,24942,-2663
4/28/2016 10:00,37790,10432,417,4712,22230,25884,-3654
4/28/2016 11:00,39944,10356,445,4712,24431,28027,-3596
4/28/2016 12:00,41882,10060,453,4712,26656,30268,-3612
4/28/2016 13:00,43712,9736,456,4712,28807,31444,-2637
4/28/2016 14:00,45571,9390,441,4712,31027,32713,-1686
4/28/2016 15:00,46889,8784,434,4712,32959,33404,-445
4/28/2016 16:00,47791,9092,425,4712,33563,33134,429
4/28/2016 17:00,48520,9500,412,4712,33896,31847,2049
4/28/2016 18:00,48406,9752,298,4712,33645,30392,3253
4/28/2016 19:00,47298,9939,73,4712,32574,30864,1710
4/28/2016 20:00,46068,9947,0,4712,31409,29604,1805
4/28/2016 21:00,46053,10279,0,4712,31062,26332,4730
4/28/2016 22:00,44786,10343,0,4712,29731,23066,6665
4/28/2016 23:00,41759,10220,0,4712,26827,20176,6651
4/29/2016 0:00,38216,10122,0,4712,23382,18432,4950
4/29/2016 1:00,35439,10093,0,4712,20634,17454,3180
4/29/2016 2:00,33621,10240,0,4712,18668,17044,1624
4/29/2016 3:00,32502,10492,0,4712,17298,17558,-260
4/29/2016 4:00,32017,9973,0,4712,17331,19012,-1681
4/29/2016 5:00,32337,10220,0,4712,17405,21941,-4536
4/29/2016 6:00,34071,9908,0,4712,19450,23269,-3819
4/29/2016 7:00,37412,9977,270,4712,22453,24006,-1553
4/29/2016 8:00,38757,10115,417,4712,23513,25483,-1970
4/29/2016 9:00,39650,10110,482,4712,24346,27343,-2997
4/29/2016 10:00,41186,10023,517,4712,25935,29023,-3088
4/29/2016 11:00,42855,9822,522,4712,27799,31075,-3276
4/29/2016 12:00,44583,8013,537,4712,31321,33185,-1864
4/29/2016 13:00,45943,7301,538,4712,33392,33755,-363
4/29/2016 14:00,47330,7014,527,4712,35077,33890,1187
4/29/2016 15:00,47770,6530,528,4712,36001,33839,2162
4/29/2016 16:00,47766,6976,506,4712,35572,32143,3429
4/29/2016 17:00,47272,8814,458,4712,33289,30174,3115
4/29/2016 18:00,46203,8849,348,4712,32294,28918,3376
4/29/2016 19:00,44877,9011,117,4712,31037,29612,1425
4/29/2016 20:00,43774,8453,0,4712,30609,28548,2061
4/29/2016 21:00,43870,8470,0,4712,30688,27198,3490
4/29/2016 22:00,42591,7270,0,4712,30609,25518,5091
4/29/2016 23:00,40143,6626,0,4712,28805,23176,5629
4/30/2016 0:00,37229,6064,0,4712,26453,21926,4527
4/30/2016 1:00,34786,5885,0,4712,24188,20788,3400
4/30/2016 2:00,32872,5083,0,4712,23077,20833,2244
4/30/2016 3:00,31533,4659,0,4712,22163,20518,1645
4/30/2016 4:00,30707,4181,0,4712,21814,21135,679
4/30/2016 5:00,30123,3278,0,4712,22132,22559,-427
4/30/2016 6:00,30174,3556,0,4712,21905,23208,-1303
4/30/2016 7:00,30845,3232,242,4712,22659,25113,-2454
4/30/2016 8:00,31554,2280,416,4712,24146,27466,-3320
4/30/2016 9:00,33052,1349,493,4712,26497,29458,-2961
4/30/2016 10:00,34700,708,503,4712,28777,31434,-2657
4/30/2016 11:00,36371,558,537,4712,30563,32661,-2098
4/30/2016 12:00,37931,682,545,4712,31993,33726,-1733
4/30/2016 13:00,39357,777,545,4712,33323,35068,-1745
4/30/2016 14:00,40895,739,542,4712,34902,36167,-1265
4/30/2016 15:00,42626,673,525,4712,36716,37202,-486
4/30/2016 16:00,44211,624,498,4712,38377,37643,734
4/30/2016 17:00,45219,761,440,4712,39307,36800,2507
4/30/2016 18:00,45553,1402,335,4712,39105,34642,4463
4/30/2016 19:00,44750,2431,99,4712,37508,32743,4765
4/30/2016 20:00,43157,5045,0,4712,33401,29494,3907
4/30/2016 21:00,42489,7119,0,4712,30659,25372,5287
4/30/2016 22:00,41144,8295,0,4712,28138,21453,6685
4/30/2016 23:00,38754,9337,0,4712,24705,18976,5729
5/1/2016 0:00,35993,9096,0,4712,22185,17770,4415
5/1/2016 1:00,33340,8116,0,4712,20512,16794,3718
5/1/2016 2:00,31394,8727,0,4712,17954,15366,2588
5/1/2016 3:00,30115,9754,0,4712,15649,14696,953
5/1/2016 4:00,29385,9649,0,4712,15024,14655,369
5/1/2016 5:00,28932,9912,0,4712,14308,14646,-338
5/1/2016 6:00,28840,9749,0,4712,14379,14909,-530
5/1/2016 7:00,29128,9633,280,4712,14502,16236,-1734
5/1/2016 8:00,29480,9888,442,4712,14439,18445,-4006
5/1/2016 9:00,31441,9698,466,4712,16565,21297,-4732
5/1/2016 10:00,33530,9262,504,4712,19052,23100,-4048
5/1/2016 11:00,35374,8769,533,4712,21361,24687,-3326
5/1/2016 12:00,36838,8004,541,4712,23581,26254,-2673
5/1/2016 13:00,38103,7082,541,4712,25768,27600,-1832
5/1/2016 14:00,39060,6580,539,4712,27229,28570,-1341
5/1/2016 15:00,40127,7273,526,4712,27615,28619,-1004
5/1/2016 16:00,41026,8031,501,4712,27781,28225,-444
5/1/2016 17:00,41696,8261,439,4712,28285,27993,292
5/1/2016 18:00,41774,8551,324,4712,28187,27426,761
5/1/2016 19:00,41017,8095,99,4712,28110,29089,-979
5/1/2016 20:00,40296,7987,0,4712,27597,28601,-1004
5/1/2016 21:00,40233,7668,0,4712,27853,26584,1269
5/1/2016 22:00,39308,7646,0,4712,26950,22947,4003
5/1/2016 23:00,36644,8081,0,4712,23851,21018,2833
5/2/2016 0:00,33446,7405,0,4712,21328,20169,1159
5/2/2016 1:00,30999,6793,0,4712,19494,19954,-460
5/2/2016 2:00,29417,5949,0,4712,18756,20267,-1511
5/2/2016 3:00,28532,5653,0,4712,18167,20916,-2749
5/2/2016 4:00,28207,5133,0,4712,18362,23433,-5071
5/2/2016 5:00,28551,4820,0,4712,19019,25252,-6233
5/2/2016 6:00,30271,5463,0,4712,20097,25668,-5571
5/2/2016 7:00,33428,5241,310,4712,23166,26316,-3150
5/2/2016 8:00,34530,4956,396,4712,24467,26764,-2297
5/2/2016 9:00,34648,4946,472,4712,24517,26885,-2368
5/2/2016 10:00,34992,5048,517,4712,24715,27133,-2418
5/2/2016 11:00,35357,4817,524,4712,25304,27207,-1903
5/2/2016 12:00,35531,4353,539,4712,25927,27930,-2003
5/2/2016 13:00,35442,4058,539,4712,26133,28449,-2316
5/2/2016 14:00,35637,3713,533,4712,26678,28929,-2251
5/2/2016 15:00,35754,3367,518,4712,27156,29398,-2242
5/2/2016 16:00,35873,2954,490,4712,27717,29910,-2193
5/2/2016 17:00,35943,2515,423,4712,28293,30297,-2004
5/2/2016 18:00,35920,1802,307,4712,29098,30703,-1605
5/2/2016 19:00,35708,1324,76,4712,29596,32248,-2652
5/2/2016 20:00,35398,1262,0,4712,29424,31447,-2023
5/2/2016 21:00,36347,1693,0,4712,29942,28651,1291
5/2/2016 22:00,35714,1834,0,4712,29169,25198,3971
5/2/2016 23:00,33045,2228,0,4712,26104,22834,3270
5/3/2016 0:00,30076,2526,0,4712,22838,21626,1212
5/3/2016 1:00,28009,2514,0,4712,20783,20931,-148
5/3/2016 2:00,26825,2757,0,4712,19356,20509,-1153
5/3/2016 3:00,26225,3080,0,4712,18433,20595,-2162
5/3/2016 4:00,26042,3667,0,4712,17663,21852,-4189
5/3/2016 5:00,26566,4000,0,4712,17854,24387,-6533
5/3/2016 6:00,28356,4134,0,4712,19510,25673,-6163
5/3/2016 7:00,31677,3239,196,4712,23530,26987,-3457
5/3/2016 8:00,32647,1976,320,4712,25639,27806,-2167
5/3/2016 9:00,32811,1837,396,4712,25865,29054,-3189
5/3/2016 10:00,33419,1250,464,4712,26993,30204,-3211
5/3/2016 11:00,34236,837,464,4712,28224,31362,-3138
5/3/2016 12:00,34990,550,490,4712,29238,32222,-2984
5/3/2016 13:00,35541,544,522,4712,29763,32944,-3181
5/3/2016 14:00,36357,510,510,4712,30625,33809,-3184
5/3/2016 15:00,37238,1564,513,4712,30448,33855,-3407
5/3/2016 16:00,38073,1733,418,4712,31210,33713,-2503
5/3/2016 17:00,38953,2838,395,4712,31008,31628,-620
5/3/2016 18:00,39353,4330,238,4712,30073,31064,-991
5/3/2016 19:00,38957,2971,78,4712,31196,32573,-1377
5/3/2016 20:00,38059,2747,0,4712,30600,31617,-1017
5/3/2016 21:00,38470,2480,0,4712,31278,29101,2177
5/3/2016 22:00,37488,1902,0,4712,30874,26253,4621
5/3/2016 23:00,34417,1619,0,4712,28086,24039,4047
5/4/2016 0:00,31020,1405,0,4712,24903,22756,2147
5/4/2016 1:00,28625,1399,0,4712,22513,21908,605
5/4/2016 2:00,27230,1525,0,4712,20993,21314,-321
5/4/2016 3:00,26377,1997,0,4712,19668,21112,-1444
5/4/2016 4:00,26023,2647,0,4712,18663,22081,-3418
5/4/2016 5:00,26394,3417,0,4712,18265,24696,-6431
5/4/2016 6:00,28122,3928,0,4712,19482,25050,-5568
5/4/2016 7:00,31353,3799,146,4712,22696,26921,-4225
5/4/2016 8:00,32387,1676,284,4712,25714,29288,-3574
5/4/2016 9:00,33107,1378,371,4712,26645,29735,-3090
5/4/2016 10:00,34256,2456,368,4712,26720,30021,-3301
5/4/2016 11:00,35462,2710,372,4712,27668,31390,-3722
5/4/2016 12:00,36625,2315,488,4712,29110,33630,-4520
5/4/2016 13:00,37855,1846,442,4712,30855,35546,-4691
5/4/2016 14:00,39392,1435,501,4712,32744,37295,-4551
5/4/2016 15:00,40872,1133,463,4712,34565,38337,-3772
5/4/2016 16:00,42393,921,353,4712,36407,38844,-2437
5/4/2016 17:00,43645,733,370,4712,37830,38768,-938
5/4/2016 18:00,44241,578,242,4712,38709,38005,704
5/4/2016 19:00,43916,581,128,4712,38495,37569,926
5/4/2016 20:00,42563,891,0,4712,36959,35886,1073
5/4/2016 21:00,41997,1466,0,4712,35819,31786,4033
5/4/2016 22:00,40434,1890,0,4712,33832,27783,6049
5/4/2016 23:00,36813,2295,0,4712,29805,24511,5294
5/5/2016 0:00,32883,3031,0,4712,25140,21820,3320
5/5/2016 1:00,29982,3841,0,4712,21428,20193,1235
5/5/2016 2:00,28237,4321,0,4712,19204,19240,-36
5/5/2016 3:00,27196,4422,0,4712,18062,19900,-1838
5/5/2016 4:00,26677,3857,0,4712,18108,22086,-3978
5/5/2016 5:00,26905,3019,0,4712,19174,25589,-6415
5/5/2016 6:00,28561,2446,0,4712,21403,27145,-5742
5/5/2016 7:00,31546,1880,153,4712,24802,28900,-4098
5/5/2016 8:00,32661,754,234,4712,26960,31271,-4311
5/5/2016 9:00,33732,486,328,4712,28206,32823,-4617
5/5/2016 10:00,35393,778,360,4712,29543,33962,-4419
5/5/2016 11:00,37059,918,432,4712,30997,35512,-4515
5/5/2016 12:00,38719,754,434,4712,32819,37062,-4243
5/5/2016 13:00,40484,750,434,4712,34589,38784,-4195
5/5/2016 14:00,42446,881,477,4712,36376,40240,-3864
5/5/2016 15:00,44215,1090,500,4712,37913,40855,-2942
5/5/2016 16:00,45868,1552,469,4712,39135,40779,-1644
5/5/2016 17:00,47060,1945,390,4712,40013,39127,886
5/5/2016 18:00,47093,2877,264,4712,39240,36643,2597
5/5/2016 19:00,45797,3891,93,4712,37100,34603,2497
5/5/2016 20:00,43750,5967,0,4712,33071,31259,1812
5/5/2016 21:00,43023,7360,0,4712,30951,26735,4216
5/5/2016 22:00,41227,8366,0,4712,28150,22189,5961
5/5/2016 23:00,37560,9194,0,4712,23654,18971,4683
5/6/2016 0:00,33542,9588,0,4712,19242,17361,1881
5/6/2016 1:00,30647,9289,0,4712,16646,16309,337
5/6/2016 2:00,28815,9271,0,4712,14832,15786,-954
5/6/2016 3:00,27699,9431,0,4712,13556,15787,-2231
5/6/2016 4:00,27085,9320,0,4712,13053,17706,-4653
5/6/2016 5:00,27232,8708,0,4712,13812,20187,-6375
5/6/2016 6:00,28681,8371,0,4712,15599,21360,-5761
5/6/2016 7:00,31535,7554,157,4712,19112,23558,-4446
5/6/2016 8:00,32590,5726,227,4712,21924,25409,-3485
5/6/2016 9:00,33758,7064,307,4712,21675,26319,-4644
5/6/2016 10:00,35594,7332,422,4712,23128,27960,-4832
5/6/2016 11:00,37449,7854,441,4712,24441,28841,-4400
5/6/2016 12:00,39029,8272,458,4712,25586,30930,-5344
5/6/2016 13:00,40714,8526,487,4712,26989,31899,-4910
5/6/2016 14:00,42719,8911,486,4712,28610,33298,-4688
5/6/2016 15:00,44490,9325,495,4712,29958,33764,-3806
5/6/2016 16:00,46149,9701,459,4712,31276,33123,-1847
5/6/2016 17:00,47311,10211,392,4712,31996,31098,898
5/6/2016 18:00,47421,11195,335,4712,31179,28471,2708
5/6/2016 19:00,46112,10610,132,4712,30657,27747,2910
5/6/2016 20:00,43675,10420,0,4712,28542,25509,3033
5/6/2016 21:00,42233,11300,0,4712,26220,21951,4269
5/6/2016 22:00,40514,12101,0,4712,23701,19059,4642
5/6/2016 23:00,37805,11356,0,4712,21737,16065,5672
5/7/2016 0:00,34537,12072,0,4712,17753,15091,2662
5/7/2016 1:00,31743,11216,0,4712,15814,14367,1447
5/7/2016 2:00,29669,10366,0,4712,14590,13717,873
5/7/2016 3:00,28241,10403,0,4712,13126,13541,-415
5/7/2016 4:00,27395,10382,0,4712,12301,13731,-1430
5/7/2016 5:00,26986,10503,0,4712,11771,14299,-2528
5/7/2016 6:00,27391,10514,0,4712,12165,14886,-2721
5/7/2016 7:00,28118,11143,128,4712,12135,16480,-4345
5/7/2016 8:00,29077,11396,227,4712,12742,18062,-5320
5/7/2016 9:00,31456,12767,282,4712,13695,19858,-6163
5/7/2016 10:00,34130,12660,331,4712,16427,21515,-5088
5/7/2016 11:00,36350,12535,365,4712,18739,22781,-4042
5/7/2016 12:00,38149,12583,442,4712,20412,23829,-3417
5/7/2016 13:00,39807,12547,495,4712,22053,25680,-3627
5/7/2016 14:00,41264,12312,508,4712,23732,27668,-3936
5/7/2016 15:00,42522,11049,493,4712,26268,28842,-2574
5/7/2016 16:00,43647,11121,450,4712,27364,28713,-1349
5/7/2016 17:00,44413,11325,426,4712,27950,26474,1476
5/7/2016 18:00,44264,12279,327,4712,26945,24409,2536
5/7/2016 19:00,43058,12679,128,4712,25540,23717,1823
5/7/2016 20:00,41205,12760,0,4712,23733,22852,881
5/7/2016 21:00,40521,13356,0,4712,22452,20693,1759
5/7/2016 22:00,39469,12916,0,4712,21841,18877,2964
5/7/2016 23:00,37260,12643,0,4712,19905,17035,2870
5/8/2016 0:00,34637,12401,0,4712,17525,15457,2068
5/8/2016 1:00,32258,12283,0,4712,15263,14397,866
5/8/2016 2:00,30439,11895,0,4712,13832,13925,-93
5/8/2016 3:00,29142,11678,0,4712,12752,13866,-1114
5/8/2016 4:00,28334,11583,0,4712,12039,14206,-2167
5/8/2016 5:00,27943,11375,0,4712,11856,14669,-2813
5/8/2016 6:00,28048,10851,0,4712,12485,16196,-3711
5/8/2016 7:00,28447,9567,147,4712,14021,18991,-4970
5/8/2016 8:00,28993,8671,248,4712,15362,20979,-5617
5/8/2016 9:00,30976,9162,316,4712,16786,22730,-5944
5/8/2016 10:00,33147,8026,392,4712,20016,24106,-4090
5/8/2016 11:00,34559,7836,427,4712,21584,23915,-2331
5/8/2016 12:00,35351,8542,434,4712,21663,23058,-1395
5/8/2016 13:00,35877,9552,440,4712,21173,22880,-1707
5/8/2016 14:00,36175,9786,419,4712,21258,22830,-1572
5/8/2016 15:00,36584,10557,385,4712,20931,22071,-1140
5/8/2016 16:00,36707,10857,349,4712,20789,21307,-518
5/8/2016 17:00,36728,11912,288,4712,19816,21131,-1315
5/8/2016 18:00,36778,11674,251,4712,20140,22062,-1922
5/8/2016 19:00,36667,10587,102,4712,21265,23794,-2529
5/8/2016 20:00,36862,10431,0,4712,21720,23416,-1696
5/8/2016 21:00,38065,10301,0,4712,23052,21639,1413
5/8/2016 22:00,37778,9583,0,4712,23482,19461,4021
5/8/2016 23:00,35633,9866,0,4712,21055,17748,3307
5/9/2016 0:00,32677,9208,0,4712,18757,17878,879
5/9/2016 1:00,30480,7384,0,4712,18385,18314,71
5/9/2016 2:00,29202,6104,0,4712,18385,19142,-757
5/9/2016 3:00,28389,5675,0,4712,18002,19316,-1314
5/9/2016 4:00,28109,5939,0,4712,17458,20723,-3265
5/9/2016 5:00,28583,6976,0,4712,16895,22277,-5382
5/9/2016 6:00,30473,7842,0,4712,17919,23519,-5600
5/9/2016 7:00,33910,8371,147,4712,20680,24259,-3579
5/9/2016 8:00,35201,7989,247,4712,22253,24902,-2649
5/9/2016 9:00,35941,9424,331,4712,21473,25031,-3558
5/9/2016 10:00,37188,10716,350,4712,21410,25902,-4492
5/9/2016 11:00,39030,11901,429,4712,21988,26894,-4906
5/9/2016 12:00,40686,12181,448,4712,23346,28053,-4707
5/9/2016 13:00,42407,12438,512,4712,24745,29267,-4522
5/9/2016 14:00,44123,12305,489,4712,26617,30939,-4322
5/9/2016 15:00,45449,12060,487,4712,28190,32414,-4224
5/9/2016 16:00,46956,12186,461,4712,29597,33610,-4013
5/9/2016 17:00,48270,11234,429,4712,31895,34218,-2323
5/9/2016 18:00,48889,9537,325,4712,34315,34711,-396
5/9/2016 19:00,48260,7792,138,4712,35618,34805,813
5/9/2016 20:00,46658,8089,0,4712,33857,32845,1012
5/9/2016 21:00,46100,9107,0,4712,32281,28319,3962
5/9/2016 22:00,44729,9878,0,4712,30139,24157,5982
5/9/2016 23:00,41272,9840,0,4712,26720,21612,5108
5/10/2016 0:00,37510,9525,0,4712,23274,20885,2389
5/10/2016 1:00,34724,8888,0,4712,21124,20479,645
5/10/2016 2:00,33103,7979,0,4712,20412,20294,118
5/10/2016 3:00,31868,7837,0,4712,19319,20531,-1212
5/10/2016 4:00,31222,7880,0,4712,18630,22219,-3589
5/10/2016 5:00,31409,7850,0,4712,18847,25170,-6323
5/10/2016 6:00,33096,7719,0,4712,20664,26888,-6224
5/10/2016 7:00,36505,6979,172,4712,24642,29595,-4953
5/10/2016 8:00,37773,5479,226,4712,27356,32655,-5299
5/10/2016 9:00,39039,4758,277,4712,29291,35365,-6074
5/10/2016 10:00,41289,5172,340,4712,31065,37168,-6103
5/10/2016 11:00,44217,6200,354,4712,32950,38720,-5770
5/10/2016 12:00,47075,7121,368,4712,34874,40033,-5159
5/10/2016 13:00,49784,7511,505,4712,37056,41958,-4902
5/10/2016 14:00,52444,8044,501,4712,39188,43156,-3968
5/10/2016 15:00,54637,8047,484,4712,41394,44058,-2664
5/10/2016 16:00,56314,7881,441,4712,43280,43864,-584
5/10/2016 17:00,57210,7497,349,4712,44652,42250,2402
5/10/2016 18:00,56747,7264,283,4712,44488,39784,4704
5/10/2016 19:00,54599,7669,178,4712,42039,37111,4928
5/10/2016 20:00,51830,9037,0,4712,38082,34800,3282
5/10/2016 21:00,49758,9437,0,4712,35609,29700,5909
5/10/2016 22:00,47290,10457,0,4712,32121,24854,7267
5/10/2016 23:00,43285,10028,0,4712,28545,22108,6437
5/11/2016 0:00,38991,9926,0,4712,24352,19830,4522
5/11/2016 1:00,35728,10580,0,4712,20436,18293,2143
5/11/2016 2:00,33659,10517,0,4712,18430,17799,631
5/11/2016 3:00,32249,10253,0,4712,17284,17891,-607
5/11/2016 4:00,31439,10306,0,4712,16421,19107,-2686
5/11/2016 5:00,31327,10618,0,4712,15997,21398,-5401
5/11/2016 6:00,32753,10274,0,4712,17767,22873,-5106
5/11/2016 7:00,35707,10036,145,4712,20814,24453,-3639
5/11/2016 8:00,36687,9671,251,4712,22053,26200,-4147
5/11/2016 9:00,37814,9575,321,4712,23206,29071,-5865
5/11/2016 10:00,39675,8886,371,4712,25706,32215,-6509
5/11/2016 11:00,42032,7281,305,4712,29734,36302,-6568
5/11/2016 12:00,44415,5493,383,4712,33827,39875,-6048
5/11/2016 13:00,46843,3682,324,4712,38125,42963,-4838
5/11/2016 14:00,49244,2562,364,4712,41606,45278,-3672
5/11/2016 15:00,51319,2190,250,4712,44167,45997,-1830
5/11/2016 16:00,52956,2537,248,4712,45459,45367,92
5/11/2016 17:00,53835,3293,183,4712,45646,43255,2391
5/11/2016 18:00,53849,4409,81,4712,44647,40602,4045
5/11/2016 19:00,52362,5019,13,4712,42619,39955,2664
5/11/2016 20:00,50179,5971,0,4712,39495,37110,2385
5/11/2016 21:00,49581,6889,0,4712,37979,32984,4995
5/11/2016 22:00,47745,7366,0,4712,35667,28266,7401
5/11/2016 23:00,43905,7511,0,4712,31682,24401,7281
5/12/2016 0:00,39228,8068,0,4712,26448,22899,3549
5/12/2016 1:00,35726,6901,0,4712,24113,22178,1935
5/12/2016 2:00,33701,6710,0,4712,22279,21679,600
5/12/2016 3:00,32291,6359,0,4712,21219,21560,-341
5/12/2016 4:00,31499,7575,0,4712,19212,22592,-3380
5/12/2016 5:00,31524,7176,0,4712,19635,25791,-6156
5/12/2016 6:00,33257,6150,0,4712,22396,27843,-5447
5/12/2016 7:00,36292,5241,42,4712,26297,29560,-3263
5/12/2016 8:00,37311,4992,32,4712,27575,30722,-3147
5/12/2016 9:00,38310,4728,117,4712,28753,32560,-3807
5/12/2016 10:00,39844,4652,145,4712,30336,34003,-3667
5/12/2016 11:00,41719,3928,185,4712,32895,35915,-3020
5/12/2016 12:00,43119,3627,157,4712,34624,38004,-3380
5/12/2016 13:00,44396,3177,186,4712,36321,39752,-3431
5/12/2016 14:00,46191,2751,192,4712,38537,40877,-2340
5/12/2016 15:00,47770,2538,175,4712,40345,42276,-1931
5/12/2016 16:00,49234,2310,220,4712,41992,42558,-566
5/12/2016 17:00,50536,2335,116,4712,43373,41767,1606
5/12/2016 18:00,50783,2226,55,4712,43790,40686,3104
5/12/2016 19:00,49419,1924,2,4712,42781,39917,2864
5/12/2016 20:00,47591,2358,0,4712,40522,37460,3062
5/12/2016 21:00,46888,3191,0,4712,38985,32714,6271
5/12/2016 22:00,45041,4245,0,4712,36084,28510,7574
5/12/2016 23:00,41391,4529,0,4712,32150,25672,6478
5/13/2016 0:00,37361,4325,0,4712,28324,23700,4624
5/13/2016 1:00,34276,4508,0,4712,25056,22096,2960
5/13/2016 2:00,32212,4708,0,4712,22791,21056,1735
5/13/2016 3:00,30854,4811,0,4712,21330,21337,-7
5/13/2016 4:00,30103,4710,0,4712,20681,22674,-1993
5/13/2016 5:00,30193,4677,0,4712,20805,25651,-4846
5/13/2016 6:00,31641,4602,0,4712,22327,26566,-4239
5/13/2016 7:00,34569,4319,65,4712,25473,28157,-2684
5/13/2016 8:00,35751,4587,213,4712,26239,29810,-3571
5/13/2016 9:00,37313,5039,262,4712,27301,32039,-4738
5/13/2016 10:00,39494,4958,293,4712,29532,34580,-5048
5/13/2016 11:00,42054,4404,316,4712,32623,37047,-4424
5/13/2016 12:00,44416,4074,376,4712,35254,39186,-3932
5/13/2016 13:00,46686,3750,373,4712,37851,40535,-2684
5/13/2016 14:00,48714,3479,368,4712,40154,42164,-2010
5/13/2016 15:00,50182,2957,416,4712,42097,42790,-693
5/13/2016 16:00,51342,3083,381,4712,43166,41815,1351
5/13/2016 17:00,51802,3442,307,4712,43341,39442,3899
5/13/2016 18:00,50818,4326,214,4712,41566,36630,4936
5/13/2016 19:00,48852,5010,86,4712,39043,34841,4202
5/13/2016 20:00,46551,6175,0,4712,35664,31893,3771
5/13/2016 21:00,45511,8780,0,4712,32019,28360,3659
5/13/2016 22:00,44095,7345,0,4712,32038,24847,7191
5/13/2016 23:00,41317,7969,0,4712,28636,22896,5740
5/14/2016 0:00,37955,7097,0,4712,26147,21547,4600
5/14/2016 1:00,34996,7331,0,4712,22952,19115,3837
5/14/2016 2:00,32902,8210,0,4712,19980,18830,1150
5/14/2016 3:00,31458,5913,0,4712,20833,20524,309
5/14/2016 4:00,30511,4764,0,4712,21035,20763,272
5/14/2016 5:00,30005,5644,0,4712,19648,20320,-672
5/14/2016 6:00,30323,6041,0,4712,19570,20315,-745
5/14/2016 7:00,30994,7545,52,4712,18685,21270,-2585
5/14/2016 8:00,31812,8375,117,4712,18608,22577,-3969
5/14/2016 9:00,33948,8829,174,4712,20233,25194,-4961
5/14/2016 10:00,36387,8430,291,4712,22954,26856,-3902
5/14/2016 11:00,38546,7564,381,4712,25889,28641,-2752
5/14/2016 12:00,39986,6984,459,4712,27832,29279,-1447
5/14/2016 13:00,40981,7130,454,4712,28684,29552,-868
5/14/2016 14:00,41490,5947,422,4712,30409,29845,564
5/14/2016 15:00,41730,5416,301,4712,31301,29805,1496
5/14/2016 16:00,41122,4438,267,4712,31705,29787,1918
5/14/2016 17:00,40062,4340,239,4712,30771,28852,1919
5/14/2016 18:00,39125,3796,105,4712,30512,28512,2000
5/14/2016 19:00,38196,3391,3,4712,30090,28988,1102
5/14/2016 20:00,37155,3246,0,4712,29196,28232,964
5/14/2016 21:00,36838,3245,0,4712,28880,26440,2440
5/14/2016 22:00,36175,3348,0,4712,28115,24251,3864
5/14/2016 23:00,34377,3185,0,4712,26480,22283,4197
5/15/2016 0:00,32072,3446,0,4712,23914,21019,2895
5/15/2016 1:00,29979,3028,0,4712,22239,20548,1691
5/15/2016 2:00,28443,2349,0,4712,21383,20416,967
5/15/2016 3:00,27413,2209,0,4712,20493,20112,381
5/15/2016 4:00,26836,2511,0,4712,19613,19974,-361
5/15/2016 5:00,26566,2569,0,4712,19285,20225,-940
5/15/2016 6:00,26694,2447,0,4712,19535,20802,-1267
5/15/2016 7:00,27014,2609,152,4712,19541,21991,-2450
5/15/2016 8:00,27616,2646,230,4712,20029,23822,-3793
5/15/2016 9:00,29476,2389,292,4712,22083,25433,-3350
5/15/2016 10:00,31396,2330,400,4712,23953,26543,-2590
5/15/2016 11:00,32894,2622,484,4712,25076,27468,-2392
5/15/2016 12:00,34011,2878,504,4712,25918,28685,-2767
5/15/2016 13:00,35120,2719,505,4712,27184,29066,-1882
5/15/2016 14:00,36056,2856,495,4712,27993,28451,-458
5/15/2016 15:00,36599,3579,488,4712,27820,28694,-874
5/15/2016 16:00,36592,3257,448,4712,28175,28578,-403
5/15/2016 17:00,36556,3858,374,4712,27612,28251,-639
5/15/2016 18:00,36620,3976,264,4712,27668,27755,-87
5/15/2016 19:00,36657,4540,159,4712,27246,28170,-924
5/15/2016 20:00,36632,4856,0,4712,27064,27673,-609
5/15/2016 21:00,37436,5203,0,4712,27521,25288,2233
5/15/2016 22:00,37084,5580,0,4712,26792,22530,4262
5/15/2016 23:00,34920,5425,0,4712,24783,20036,4747
5/16/2016 0:00,32020,6156,0,4712,21152,18133,3019
5/16/2016 1:00,29778,6184,0,4712,18881,17427,1454
5/16/2016 2:00,28456,6029,0,4712,17715,18062,-347
5/16/2016 3:00,27720,4828,0,4712,18181,19195,-1014
5/16/2016 4:00,27528,4952,0,4712,17863,21613,-3750
5/16/2016 5:00,28020,3621,0,4712,19686,25615,-5929
5/16/2016 6:00,29867,3212,0,4712,21942,26853,-4911
5/16/2016 7:00,33125,3141,138,4712,25134,26992,-1858
5/16/2016 8:00,34399,4243,233,4712,25210,27067,-1857
5/16/2016 9:00,34942,4668,327,4712,25236,27884,-2648
5/16/2016 10:00,35798,5268,407,4712,25411,28648,-3237
5/16/2016 11:00,36895,5386,424,4712,26373,30439,-4066
5/16/2016 12:00,38132,4817,441,4712,28162,32374,-4212
5/16/2016 13:00,39352,4081,503,4712,30057,33513,-3456
5/16/2016 14:00,40609,3611,488,4712,31797,33794,-1997
5/16/2016 15:00,41511,3871,454,4712,32473,33817,-1344
5/16/2016 16:00,42139,4551,443,4712,32433,33066,-633
5/16/2016 17:00,42674,6619,367,4712,30977,31056,-79
5/16/2016 18:00,42844,8224,290,4712,29618,29038,580
5/16/2016 19:00,42425,9459,141,4712,28112,28349,-237
5/16/2016 20:00,41618,10354,0,4712,26551,26666,-115
5/16/2016 21:00,41929,11434,0,4712,25784,22861,2923
5/16/2016 22:00,41250,11154,0,4712,25384,20027,5357
5/16/2016 23:00,38101,10753,0,4712,22636,18479,4157
5/17/2016 0:00,34542,10306,0,4712,19524,17069,2455
5/17/2016 1:00,31766,9801,0,4712,17253,16485,768
5/17/2016 2:00,30161,9591,0,4712,15858,16804,-946
5/17/2016 3:00,29101,8051,0,4712,16338,18824,-2486
5/17/2016 4:00,28600,5995,0,4712,17893,21176,-3283
5/17/2016 5:00,28871,6085,0,4712,18074,22640,-4566
5/17/2016 6:00,30584,7475,0,4712,18397,22852,-4455
5/17/2016 7:00,33825,8631,184,4712,20298,23553,-3255
5/17/2016 8:00,35119,7750,296,4712,22361,25295,-2934
5/17/2016 9:00,35847,7660,365,4712,23110,27219,-4109
5/17/2016 10:00,37196,7020,371,4712,25094,29755,-4661
5/17/2016 11:00,38784,5944,401,4712,27727,31973,-4246
5/17/2016 12:00,40138,5174,484,4712,29768,33198,-3430
5/17/2016 13:00,41542,5690,475,4712,30665,32971,-2306
5/17/2016 14:00,43204,7382,423,4712,30687,33489,-2802
5/17/2016 15:00,44810,7568,422,4712,32108,33167,-1059
5/17/2016 16:00,46136,9318,415,4712,31691,31534,157
5/17/2016 17:00,46828,10938,347,4712,30831,29841,990
5/17/2016 18:00,46566,11678,284,4712,29892,28460,1432
5/17/2016 19:00,45446,10808,143,4712,29784,28792,992
5/17/2016 20:00,43916,10630,0,4712,28574,28069,505
5/17/2016 21:00,43684,9852,0,4712,29120,24848,4272
5/17/2016 22:00,42349,9909,0,4712,27728,20888,6840
5/17/2016 23:00,38923,10041,0,4712,24170,19303,4867
5/18/2016 0:00,34972,8008,0,4712,22252,19451,2801
5/18/2016 1:00,31970,6454,0,4712,20803,18127,2676
5/18/2016 2:00,30158,7974,0,4712,17471,16500,971
5/18/2016 3:00,29093,7697,0,4712,16684,17583,-899
5/18/2016 4:00,28549,6998,0,4712,16840,19923,-3083
5/18/2016 5:00,28644,5455,0,4712,18476,23463,-4987
5/18/2016 6:00,30161,5022,0,4712,20427,24544,-4117
5/18/2016 7:00,33238,4658,186,4712,23683,24943,-1260
5/18/2016 8:00,34230,5733,290,4712,23495,25845,-2350
5/18/2016 9:00,34692,4876,367,4712,24738,27423,-2685
5/18/2016 10:00,35787,4107,416,4712,26551,29496,-2945
5/18/2016 11:00,36866,3607,488,4712,28059,30160,-2101
5/18/2016 12:00,37877,3349,486,4712,29330,30790,-1460
5/18/2016 13:00,38636,3000,493,4712,30431,31488,-1057
5/18/2016 14:00,39478,2854,490,4712,31422,32355,-933
5/18/2016 15:00,40052,2048,472,4712,32820,32720,100
5/18/2016 16:00,40530,1792,414,4712,33611,32856,755
5/18/2016 17:00,40663,2572,354,4712,33025,32412,613
5/18/2016 18:00,40305,2105,226,4712,33262,32219,1043
5/18/2016 19:00,39552,1651,66,4712,33123,32709,414
5/18/2016 20:00,38975,1459,0,4712,32805,31640,1165
5/18/2016 21:00,39186,1740,0,4712,32734,29034,3700
5/18/2016 22:00,38330,1661,0,4712,31956,26522,5434
5/18/2016 23:00,35535,1866,0,4712,28957,24172,4785
5/19/2016 0:00,32386,1805,0,4712,25870,22625,3245
5/19/2016 1:00,29978,2280,0,4712,22987,21771,1216
5/19/2016 2:00,28597,2026,0,4712,21859,21258,601
5/19/2016 3:00,27718,2167,0,4712,20839,21931,-1092
5/19/2016 4:00,27387,1681,0,4712,20994,24159,-3165
5/19/2016 5:00,27757,1479,0,4712,21567,26887,-5320
5/19/2016 6:00,29458,1606,0,4712,23140,27749,-4609
5/19/2016 7:00,32698,1795,154,4712,26037,28372,-2335
5/19/2016 8:00,34043,1480,225,4712,27626,29680,-2054
5/19/2016 9:00,34585,989,334,4712,28550,31056,-2506
5/19/2016 10:00,35602,1203,391,4712,29296,31454,-2158
5/19/2016 11:00,36241,926,492,4712,30111,31373,-1262
5/19/2016 12:00,36521,1091,507,4712,30211,31296,-1085
5/19/2016 13:00,36492,1021,509,4712,30250,30836,-586
5/19/2016 14:00,36422,1228,499,4712,29984,30284,-300
5/19/2016 15:00,36253,1631,487,4712,29424,30331,-907
5/19/2016 16:00,36277,1729,477,4712,29358,30328,-970
5/19/2016 17:00,36497,1765,434,4712,29587,30180,-593
5/19/2016 18:00,36481,1583,330,4712,29856,30187,-331
5/19/2016 19:00,36039,1228,134,4712,29966,31003,-1037
5/19/2016 20:00,35666,1546,0,4712,29408,30346,-938
5/19/2016 21:00,36427,2338,0,4712,29376,27738,1638
5/19/2016 22:00,36275,2939,0,4712,28624,24355,4269
5/19/2016 23:00,33896,3132,0,4712,26052,22120,3932
5/20/2016 0:00,30911,3228,0,4712,22971,20687,2284
5/20/2016 1:00,28746,3342,0,4712,20693,20062,631
5/20/2016 2:00,27491,3113,0,4712,19666,19796,-130
5/20/2016 3:00,26720,3248,0,4712,18760,20208,-1448
5/20/2016 4:00,26406,3136,0,4712,18558,21568,-3010
5/20/2016 5:00,26755,3314,0,4712,18729,24335,-5606
5/20/2016 6:00,28416,3167,0,4712,20536,25564,-5028
5/20/2016 7:00,31396,3143,97,4712,23443,26603,-3160
5/20/2016 8:00,32675,3203,170,4712,24591,27734,-3143
5/20/2016 9:00,33663,3522,218,4712,25211,29011,-3800
5/20/2016 10:00,34954,3435,387,4712,26421,30746,-4325
5/20/2016 11:00,36423,3198,466,4712,28046,32259,-4213
5/20/2016 12:00,37839,2754,487,4712,29886,33973,-4087
5/20/2016 13:00,39216,2835,487,4712,31182,35281,-4099
5/20/2016 14:00,41054,3084,477,4712,32781,36323,-3542
5/20/2016 15:00,42839,3730,370,4712,34026,37036,-3010
5/20/2016 16:00,44498,4137,314,4712,35335,37227,-1892
5/20/2016 17:00,45803,4658,325,4712,36107,36053,54
5/20/2016 18:00,46189,5677,260,4712,35540,33732,1808
5/20/2016 19:00,45142,6276,101,4712,34053,32114,1939
5/20/2016 20:00,43230,7716,0,4712,30802,29385,1417
5/20/2016 21:00,42183,9444,0,4712,28027,25286,2741
5/20/2016 22:00,41250,10485,0,4712,26052,21316,4736
5/20/2016 23:00,38769,10890,0,4712,23167,18355,4812
5/21/2016 0:00,35705,11113,0,4712,19880,16690,3190
5/21/2016 1:00,32917,10840,0,4712,17365,16204,1161
5/21/2016 2:00,31009,9769,0,4712,16528,16010,518
5/21/2016 3:00,29682,9686,0,4712,15284,16014,-730
5/21/2016 4:00,28920,9032,0,4712,15176,17196,-2020
5/21/2016 5:00,28604,8268,0,4712,15623,18161,-2538
5/21/2016 6:00,28904,8017,0,4712,16176,19571,-3395
5/21/2016 7:00,29553,7376,40,4712,17425,22206,-4781
5/21/2016 8:00,30730,7214,76,4712,18728,24281,-5553
5/21/2016 9:00,33200,7881,106,4712,20501,26274,-5773
5/21/2016 10:00,35867,7932,178,4712,23045,28761,-5716
5/21/2016 11:00,38454,7683,214,4712,25845,30589,-4744
5/21/2016 12:00,40552,7222,288,4712,28330,32364,-4034
5/21/2016 13:00,41945,6777,328,4712,30128,34375,-4247
5/21/2016 14:00,43382,6728,258,4712,31684,35498,-3814
5/21/2016 15:00,45001,6790,318,4712,33180,35605,-2425
5/21/2016 16:00,46217,7189,268,4712,34047,34488,-441
5/21/2016 17:00,46622,7398,166,4712,34347,32596,1751
5/21/2016 18:00,45769,8133,116,4712,32808,31166,1642
5/21/2016 19:00,44465,7901,38,4712,31814,30623,1191
5/21/2016 20:00,43114,8113,0,4712,30289,29931,358
5/21/2016 21:00,42494,8512,0,4712,29270,26925,2345
5/21/2016 22:00,41899,9398,0,4712,27788,23616,4172
5/21/2016 23:00,39684,9908,0,4712,25064,20549,4515
5/22/2016 0:00,37040,10535,0,4712,21793,18588,3205
5/22/2016 1:00,34534,10345,0,4712,19477,17643,1834
5/22/2016 2:00,32718,10053,0,4712,17953,17440,513
5/22/2016 3:00,31423,8761,0,4712,17950,18411,-461
5/22/2016 4:00,30560,7298,0,4712,18550,19135,-585
5/22/2016 5:00,30049,6427,0,4712,18910,20081,-1171
5/22/2016 6:00,30010,5656,0,4712,19642,21640,-1998
5/22/2016 7:00,30275,4376,43,4712,21144,24446,-3302
5/22/2016 8:00,30919,3991,90,4712,22126,26622,-4496
5/22/2016 9:00,33062,4845,141,4712,23365,27544,-4179
5/22/2016 10:00,35530,6448,156,4712,24214,29311,-5097
5/22/2016 11:00,37976,6508,255,4712,26501,32256,-5755
5/22/2016 12:00,40433,6591,367,4712,28763,33769,-5006
5/22/2016 13:00,42714,6990,417,4712,30596,35138,-4542
5/22/2016 14:00,44737,7475,424,4712,32127,35727,-3600
5/22/2016 15:00,46323,8061,385,4712,33165,35605,-2440
5/22/2016 16:00,47745,10145,407,4712,32480,34173,-1693
5/22/2016 17:00,48976,11036,352,4712,32876,33763,-887
5/22/2016 18:00,49427,10861,220,4712,33633,32144,1489
5/22/2016 19:00,48837,11540,74,4712,32511,31473,1038
5/22/2016 20:00,47442,11043,0,4712,31687,31328,359
5/22/2016 21:00,46798,9884,0,4712,32202,27706,4496
5/22/2016 22:00,45635,11176,0,4712,29746,23455,6291
5/22/2016 23:00,42465,10738,0,4712,27015,21354,5661
5/23/2016 0:00,38407,10171,0,4712,23524,19557,3967
5/23/2016 1:00,35271,9847,0,4712,20712,18353,2359
5/23/2016 2:00,33258,9601,0,4712,18946,18178,768
5/23/2016 3:00,31987,9343,0,4712,17932,18505,-573
5/23/2016 4:00,31363,9350,0,4712,17301,20298,-2997
5/23/2016 5:00,31548,9396,0,4712,17440,22773,-5333
5/23/2016 6:00,33245,9282,0,4712,19251,24900,-5649
5/23/2016 7:00,36325,8082,49,4712,23482,26581,-3099
5/23/2016 8:00,37696,8174,142,4712,24668,27661,-2993
5/23/2016 9:00,38624,7994,196,4712,25722,30094,-4372
5/23/2016 10:00,39909,6759,284,4712,28155,33755,-5600
5/23/2016 11:00,41687,5521,390,4712,31064,35875,-4811
5/23/2016 12:00,43665,5395,433,4712,33125,36911,-3786
5/23/2016 13:00,45447,5967,376,4712,34392,37552,-3160
5/23/2016 14:00,47104,6511,390,4712,35492,36880,-1388
5/23/2016 15:00,48509,7951,418,4712,35428,36010,-582
5/23/2016 16:00,49069,8684,319,4712,35354,35583,-229
5/23/2016 17:00,49433,9698,200,4712,34823,34212,611
5/23/2016 18:00,49390,10642,56,4712,33980,33310,670
5/23/2016 19:00,48379,10429,40,4712,33198,33316,-118
5/23/2016 20:00,47275,10239,0,4712,32323,31690,633
5/23/2016 21:00,47223,11297,0,4712,31214,27805,3409
5/23/2016 22:00,46193,11456,0,4712,30025,23680,6345
5/23/2016 23:00,42940,11430,0,4712,26798,21377,5421
5/24/2016 0:00,39029,10776,0,4712,23540,20269,3271
5/24/2016 1:00,36137,10488,0,4712,20937,19452,1485
5/24/2016 2:00,34398,10429,0,4712,19257,18967,290
5/24/2016 3:00,33272,10070,0,4712,18490,19249,-759
5/24/2016 4:00,32657,9747,0,4712,18198,21753,-3555
5/24/2016 5:00,32859,8764,0,4712,19383,25689,-6306
5/24/2016 6:00,34505,7926,0,4712,21867,27368,-5501
5/24/2016 7:00,37629,7261,151,4712,25505,28886,-3381
5/24/2016 8:00,38950,8095,258,4712,25886,29747,-3861
5/24/2016 9:00,40107,8624,332,4712,26439,31835,-5396
5/24/2016 10:00,41900,8143,405,4712,28641,34105,-5464
5/24/2016 11:00,43967,7663,479,4712,31113,36563,-5450
5/24/2016 12:00,45746,6867,469,4712,33698,38616,-4918
5/24/2016 13:00,47436,6584,510,4712,35631,40024,-4393
5/24/2016 14:00,49275,6587,506,4712,37469,40575,-3106
5/24/2016 15:00,50672,6866,501,4712,38593,40456,-1863
5/24/2016 16:00,51757,8287,458,4712,38301,39381,-1080
5/24/2016 17:00,52646,9625,399,4712,37910,37545,365
5/24/2016 18:00,52783,10041,380,4712,37650,35919,1731
5/24/2016 19:00,51659,10352,218,4712,36376,35483,893
5/24/2016 20:00,50198,11038,0,4712,34449,33732,717
5/24/2016 21:00,49955,11307,0,4712,33936,30570,3366
5/24/2016 22:00,48826,11193,0,4712,32921,27047,5874
5/24/2016 23:00,45567,11098,0,4712,29757,23623,6134
5/25/2016 0:00,41714,11113,0,4712,25889,21792,4097
5/25/2016 1:00,38705,10984,0,4712,23008,20818,2190
5/25/2016 2:00,36859,10396,0,4712,21751,20823,928
5/25/2016 3:00,35671,9858,0,4712,21101,21384,-283
5/25/2016 4:00,35001,9256,0,4712,21033,24266,-3233
5/25/2016 5:00,35219,8110,0,4712,22397,27671,-5274
5/25/2016 6:00,36854,7210,0,4712,24931,30080,-5149
5/25/2016 7:00,39918,5924,141,4712,29141,32346,-3205
5/25/2016 8:00,41206,5644,240,4712,30610,34122,-3512
5/25/2016 9:00,42505,6173,383,4712,31236,36552,-5316
5/25/2016 10:00,44448,5465,405,4712,33865,39275,-5410
5/25/2016 11:00,46655,4143,413,4712,37387,41333,-3946
5/25/2016 12:00,48606,3666,495,4712,39733,42842,-3109
5/25/2016 13:00,50266,3834,470,4712,41250,43683,-2433
5/25/2016 14:00,51744,4019,478,4712,42536,44083,-1547
5/25/2016 15:00,53049,4516,457,4712,43363,43922,-559
5/25/2016 16:00,53928,5595,435,4712,43187,42796,391
5/25/2016 17:00,54511,6637,399,4712,42763,40770,1993
5/25/2016 18:00,54072,8125,294,4712,40941,38630,2311
5/25/2016 19:00,52795,8035,146,4712,39903,38661,1242
5/25/2016 20:00,51467,8181,0,4712,38574,36365,2209
5/25/2016 21:00,51219,10114,0,4712,36393,32725,3668
5/25/2016 22:00,50253,10198,0,4712,35343,28229,7114
5/25/2016 23:00,46866,11149,0,4712,31005,25171,5834
5/26/2016 0:00,43009,10835,0,4712,27462,23662,3800
5/26/2016 1:00,39903,10254,0,4712,24937,22252,2685
5/26/2016 2:00,37718,10360,0,4712,22646,22271,375
5/26/2016 3:00,36301,8990,0,4712,22599,23217,-618
5/26/2016 4:00,35660,8171,0,4712,22777,25788,-3011
5/26/2016 5:00,35912,6420,0,4712,24781,28605,-3824
5/26/2016 6:00,37652,7917,1,4712,25022,29218,-4196
5/26/2016 7:00,40711,7416,142,4712,28441,29530,-1089
5/26/2016 8:00,41919,9243,252,4712,27712,30070,-2358
5/26/2016 9:00,42734,9774,392,4712,27855,30786,-2931
5/26/2016 10:00,44059,9974,401,4712,28972,31756,-2784
5/26/2016 11:00,45392,9138,426,4712,31116,33022,-1906
5/26/2016 12:00,46443,8893,485,4712,32353,33567,-1214
5/26/2016 13:00,47262,9085,510,4712,32955,33436,-481
5/26/2016 14:00,47932,9368,480,4712,33371,33986,-615
5/26/2016 15:00,48397,9387,455,4712,33843,33845,-2
5/26/2016 16:00,48772,10079,422,4712,33558,33784,-226
5/26/2016 17:00,48974,8898,372,4712,34992,33560,1432
5/26/2016 18:00,48580,10215,267,4712,33386,30929,2457
5/26/2016 19:00,47674,11185,113,4712,31663,30328,1335
5/26/2016 20:00,46251,10703,0,4712,30836,30554,282
5/26/2016 21:00,45722,8732,0,4712,32278,28458,3820
5/26/2016 22:00,44681,8806,0,4712,31163,25347,5816
5/26/2016 23:00,41698,7817,0,4712,29169,22753,6416
5/27/2016 0:00,37820,8363,0,4712,24745,20651,4094
5/27/2016 1:00,34731,7430,0,4712,22589,19622,2967
5/27/2016 2:00,32810,7704,0,4712,20394,19982,412
5/27/2016 3:00,31720,6633,0,4712,20375,21174,-799
5/27/2016 4:00,31155,5247,0,4712,21197,23153,-1956
5/27/2016 5:00,31361,5043,0,4712,21606,26081,-4475
5/27/2016 6:00,32712,4807,1,4712,23192,27437,-4245
5/27/2016 7:00,35160,4793,125,4712,25530,28685,-3155
5/27/2016 8:00,36481,4478,227,4712,27065,30763,-3698
5/27/2016 9:00,37853,4258,397,4712,28487,32681,-4194
5/27/2016 10:00,39817,4337,446,4712,30322,33876,-3554
5/27/2016 11:00,41717,5062,501,4712,31442,33852,-2410
5/27/2016 12:00,43162,5841,500,4712,32110,33713,-1603
5/27/2016 13:00,43939,6507,495,4712,32225,34232,-2007
5/27/2016 14:00,44794,6514,490,4712,33078,34271,-1193
5/27/2016 15:00,45426,6623,467,4712,33624,34196,-572
5/27/2016 16:00,45713,6522,426,4712,34053,33915,138
5/27/2016 17:00,45535,5710,358,4712,34754,33691,1063
5/27/2016 18:00,44716,4904,303,4712,34796,33134,1662
5/27/2016 19:00,43431,4002,149,4712,34568,32284,2284
5/27/2016 20:00,41857,3841,0,4712,33304,31316,1988
5/27/2016 21:00,40539,4119,0,4712,31708,28098,3610
5/27/2016 22:00,39637,5455,0,4712,29470,24545,4925
5/27/2016 23:00,37272,5813,0,4712,26746,22207,4539
5/28/2016 0:00,34571,5398,0,4712,24461,20264,4197
5/28/2016 1:00,32002,5645,0,4712,21645,19042,2603
5/28/2016 2:00,30259,6029,0,4712,19517,18182,1335
5/28/2016 3:00,29176,6251,0,4712,18214,17676,538
5/28/2016 4:00,28576,6829,0,4712,17034,17904,-870
5/28/2016 5:00,28389,6813,0,4712,16864,18751,-1887
5/28/2016 6:00,28796,5995,1,4712,18087,20383,-2296
5/28/2016 7:00,29421,4538,122,4712,20049,24033,-3984
5/28/2016 8:00,30419,3941,220,4712,21546,27172,-5626
5/28/2016 9:00,32899,3527,277,4712,24383,30043,-5660
5/28/2016 10:00,35663,3331,345,4712,27276,32672,-5396
5/28/2016 11:00,38433,3277,443,4712,30000,34920,-4920
5/28/2016 12:00,41109,3211,462,4712,32724,36466,-3742
5/28/2016 13:00,43596,3250,434,4712,35200,38044,-2844
5/28/2016 14:00,45878,3443,413,4712,37311,40008,-2697
5/28/2016 15:00,48099,3840,443,4712,39104,41139,-2035
5/28/2016 16:00,49985,4363,421,4712,40488,41020,-532
5/28/2016 17:00,51354,5493,338,4712,40810,38910,1900
5/28/2016 18:00,51764,6090,303,4712,40659,37288,3371
5/28/2016 19:00,50741,5364,193,4712,40472,36459,4013
5/28/2016 20:00,48697,5367,0,4712,38619,34524,4095
5/28/2016 21:00,47423,6450,0,4712,36261,30681,5580
5/28/2016 22:00,46110,8075,0,4712,33323,27379,5944
5/28/2016 23:00,43334,8815,0,4712,29808,24401,5407
5/29/2016 0:00,40206,7357,0,4712,28137,22979,5158
5/29/2016 1:00,37141,7279,0,4712,25150,21480,3670
5/29/2016 2:00,34846,7858,0,4712,22276,19416,2860
5/29/2016 3:00,33233,8958,0,4712,19563,18291,1272
5/29/2016 4:00,32157,8522,0,4712,18923,18528,395
5/29/2016 5:00,31334,7523,0,4712,19100,19041,59
5/29/2016 6:00,30761,6851,3,4712,19195,19958,-763
5/29/2016 7:00,30499,5547,175,4712,20065,21952,-1887
5/29/2016 8:00,30647,5772,264,4712,19899,24253,-4354
5/29/2016 9:00,32569,6067,400,4712,21389,27021,-5632
5/29/2016 10:00,35345,5897,409,4712,24328,29406,-5078
5/29/2016 11:00,38299,7264,449,4712,25873,31074,-5201
5/29/2016 12:00,41206,7352,471,4712,28671,33091,-4420
5/29/2016 13:00,43807,6525,506,4712,32065,35281,-3216
5/29/2016 14:00,46161,6834,504,4712,34111,36602,-2491
5/29/2016 15:00,48102,7068,493,4712,35830,36915,-1085
5/29/2016 16:00,49481,7332,421,4712,37016,36301,715
5/29/2016 17:00,50364,7757,411,4712,37484,35370,2114
5/29/2016 18:00,50215,7059,313,4712,38132,34149,3983
5/29/2016 19:00,48805,6464,222,4712,37407,32567,4840
5/29/2016 20:00,46518,7227,0,4712,34579,30727,3852
5/29/2016 21:00,45013,8497,0,4712,31804,26692,5112
5/29/2016 22:00,43885,9947,0,4712,29226,22712,6514
5/29/2016 23:00,41221,10690,0,4712,25819,20676,5143
5/30/2016 0:00,38117,8475,0,4712,24930,20793,4137
5/30/2016 1:00,35233,5595,0,4712,24926,21044,3882
5/30/2016 2:00,33027,4251,0,4712,24064,21814,2250
5/30/2016 3:00,31524,2952,0,4712,23861,22939,922
5/30/2016 4:00,30555,2376,0,4712,23467,23573,-106
5/30/2016 5:00,30137,2484,0,4712,22940,23962,-1022
5/30/2016 6:00,30349,2137,1,4712,23499,24117,-618
5/30/2016 7:00,30692,1900,119,4712,23961,25569,-1608
5/30/2016 8:00,30814,1396,216,4712,24490,28473,-3983
5/30/2016 9:00,32523,645,282,4712,26885,30514,-3629
5/30/2016 10:00,34927,1350,383,4712,28482,31785,-3303
5/30/2016 11:00,37430,2284,457,4712,29978,32590,-2612
5/30/2016 12:00,39529,2982,472,4712,31363,34431,-3068
5/30/2016 13:00,41224,3228,505,4712,32779,35964,-3185
5/30/2016 14:00,43401,3459,498,4712,34731,37562,-2831
5/30/2016 15:00,45624,3626,454,4712,36832,38746,-1914
5/30/2016 16:00,47743,4318,417,4712,38297,38908,-611
5/30/2016 17:00,49424,4528,366,4712,39818,37782,2036
5/30/2016 18:00,50183,5561,212,4712,39698,35493,4205
5/30/2016 19:00,49450,5934,91,4712,38713,34409,4304
5/30/2016 20:00,47801,6359,0,4712,36730,32537,4193
5/30/2016 21:00,46664,7320,0,4712,34631,29061,5570
5/30/2016 22:00,45405,7710,0,4712,32983,24919,8064
5/30/2016 23:00,41973,7675,0,4712,29586,22598,6988
5/31/2016 0:00,37998,6872,0,4712,26414,21401,5013
5/31/2016 1:00,34887,6615,0,4712,23560,20748,2812
5/31/2016 2:00,32905,4979,0,4712,23214,21501,1713
5/31/2016 3:00,31522,4256,0,4712,22554,21423,1131
5/31/2016 4:00,30912,4551,0,4712,21649,23268,-1619
5/31/2016 5:00,31101,4968,0,4712,21421,25450,-4029
5/31/2016 6:00,32699,4447,3,4712,23537,27930,-4393
5/31/2016 7:00,35579,3125,175,4712,27567,30523,-2956
5/31/2016 8:00,37350,3372,175,4712,29091,32523,-3432
5/31/2016 9:00,39446,2763,310,4712,31660,35694,-4034
5/31/2016 10:00,41933,2655,424,4712,34143,37349,-3206
5/31/2016 11:00,44686,3394,437,4712,36144,38738,-2594
5/31/2016 12:00,47327,3341,491,4712,38783,39861,-1078
5/31/2016 13:00,49449,3214,511,4712,41012,39679,1333
5/31/2016 14:00,50619,3830,497,4712,41580,38421,3159
5/31/2016 15:00,50392,4872,488,4712,40320,36003,4317
5/31/2016 16:00,49407,6692,458,4712,37544,33214,4330
5/31/2016 17:00,48167,7074,401,4712,35980,32740,3240
5/31/2016 18:00,46539,5309,331,4712,36187,31897,4290
5/31/2016 19:00,44758,5885,146,4712,34015,31448,2567
5/31/2016 20:00,43447,5639,0,4712,33096,30201,2895
5/31/2016 21:00,43102,5452,0,4712,32938,28462,4476
5/31/2016 22:00,41935,4551,0,4712,32672,24993,7679
5/31/2016 23:00,39098,4611,0,4712,29775,22891,6884
6/1/2016 0:00,35588,4002,0,4712,26874,21984,4890
6/1/2016 1:00,32804,3372,0,4712,24721,21456,3265
6/1/2016 2:00,31133,2717,0,4712,23704,21424,2280
6/1/2016 3:00,30059,2220,0,4712,23127,22340,787
6/1/2016 4:00,29526,1851,0,4712,22963,23697,-734
6/1/2016 5:00,29807,1835,0,4712,23260,25997,-2737
6/1/2016 6:00,31323,1761,16,4712,24834,26909,-2075
6/1/2016 7:00,34038,1539,295,4712,27492,28297,-805
6/1/2016 8:00,35501,1294,440,4712,29055,29945,-890
6/1/2016 9:00,36856,1497,496,4712,30150,31632,-1482
6/1/2016 10:00,38851,1535,493,4712,32111,33351,-1240
6/1/2016 11:00,40979,1304,515,4712,34448,34883,-435
6/1/2016 12:00,42769,1675,513,4712,35869,36457,-588
6/1/2016 13:00,44297,1507,528,4712,37550,37637,-87
6/1/2016 14:00,46153,1525,518,4712,39398,38537,861
6/1/2016 15:00,47735,1321,520,4712,41182,38385,2797
6/1/2016 16:00,48887,1362,497,4712,42315,38222,4093
6/1/2016 17:00,48966,2249,449,4712,41557,36975,4582
6/1/2016 18:00,48466,2493,354,4712,40906,35765,5141
6/1/2016 19:00,47349,2228,192,4712,40217,34700,5517
6/1/2016 20:00,45730,2932,0,4712,38086,33763,4323
6/1/2016 21:00,44886,2386,0,4712,37788,31053,6735
6/1/2016 22:00,43688,2644,0,4712,36332,27705,8627
6/1/2016 23:00,40500,2706,0,4712,33082,24698,8384
6/2/2016 0:00,36797,2241,0,4712,29844,23859,5985
6/2/2016 1:00,33951,1535,0,4712,27704,23211,4493
6/2/2016 2:00,32158,1071,0,4712,26376,23118,3258
6/2/2016 3:00,31007,880,0,4712,25415,23027,2388
6/2/2016 4:00,30413,1432,0,4712,24269,24198,71
6/2/2016 5:00,30615,1527,0,4712,24376,26067,-1691
6/2/2016 6:00,32224,1843,13,4712,25656,26772,-1116
6/2/2016 7:00,34940,2024,194,4712,28010,27427,583
6/2/2016 8:00,36307,2181,308,4712,29106,28484,622
6/2/2016 9:00,37359,2255,476,4712,29915,29473,442
6/2/2016 10:00,38564,2394,506,4712,30952,30539,413
6/2/2016 11:00,39703,2858,510,4712,31624,31384,240
6/2/2016 12:00,40872,2958,522,4712,32680,32194,486
6/2/2016 13:00,41815,2625,521,4712,33957,32966,991
6/2/2016 14:00,42549,1983,516,4712,35339,33806,1533
6/2/2016 15:00,42934,1872,490,4712,35860,33923,1937
6/2/2016 16:00,43465,1968,467,4712,36318,33940,2378
6/2/2016 17:00,43778,1793,457,4712,36816,33306,3510
6/2/2016 18:00,43277,1571,363,4712,36631,32324,4307
6/2/2016 19:00,42235,1472,209,4712,35842,32164,3678
6/2/2016 20:00,40999,1140,0,4712,35147,31501,3646
6/2/2016 21:00,40462,1413,0,4712,34337,29336,5001
6/2/2016 22:00,39735,1586,0,4712,33437,26692,6745
6/2/2016 23:00,37346,1715,0,4712,30919,23643,7276
6/3/2016 0:00,34295,2587,0,4712,26996,21584,5412
6/3/2016 1:00,31749,3022,0,4712,24016,20273,3743
6/3/2016 2:00,30162,3053,0,4712,22397,19838,2559
6/3/2016 3:00,29213,3144,0,4712,21357,19586,1771
6/3/2016 4:00,28699,3685,0,4712,20302,20897,-595
6/3/2016 5:00,28870,3449,0,4712,20709,23476,-2767
6/3/2016 6:00,30252,3743,22,4712,21774,23908,-2134
6/3/2016 7:00,32579,4002,241,4712,23623,25611,-1988
6/3/2016 8:00,34060,3912,357,4712,25079,27151,-2072
6/3/2016 9:00,35535,3859,399,4712,26564,29598,-3034
6/3/2016 10:00,37379,3730,454,4712,28484,31507,-3023
6/3/2016 11:00,39570,3608,522,4712,30728,32982,-2254
6/3/2016 12:00,41593,3285,524,4712,33071,34437,-1366
6/3/2016 13:00,43413,3524,527,4712,34650,34725,-75
6/3/2016 14:00,45235,3888,525,4712,36109,35643,466
6/3/2016 15:00,46346,2779,514,4712,38341,35478,2863
6/3/2016 16:00,46430,3184,492,4712,38042,34540,3502
6/3/2016 17:00,46128,2796,439,4712,38181,33620,4561
6/3/2016 18:00,45084,2546,321,4712,37506,32646,4860
6/3/2016 19:00,43522,1836,162,4712,36812,32421,4391
6/3/2016 20:00,41850,1583,0,4712,35555,31995,3560
6/3/2016 21:00,41131,1586,0,4712,34833,29878,4955
6/3/2016 22:00,40462,1473,0,4712,34277,27727,6550
6/3/2016 23:00,38304,1349,0,4712,32243,25671,6572
6/4/2016 0:00,35544,958,0,4712,29874,24224,5650
6/4/2016 1:00,32911,757,0,4712,27442,23169,4273
6/4/2016 2:00,31114,524,0,4712,25878,22413,3465
6/4/2016 3:00,29823,672,0,4712,24439,21897,2542
6/4/2016 4:00,29020,958,0,4712,23349,21969,1380
6/4/2016 5:00,28631,1205,0,4712,22713,22071,642
6/4/2016 6:00,28890,2294,0,4712,21883,22023,-140
6/4/2016 7:00,29546,2176,142,4712,22515,23766,-1251
6/4/2016 8:00,30363,1669,244,4712,23738,25337,-1599
6/4/2016 9:00,32166,2632,300,4712,24521,26406,-1885
6/4/2016 10:00,34354,3270,392,4712,25980,27557,-1577
6/4/2016 11:00,36457,3657,509,4712,27579,28789,-1210
6/4/2016 12:00,38277,4148,508,4712,28909,29573,-664
6/4/2016 13:00,39985,4594,515,4712,30164,30195,-31
6/4/2016 14:00,41354,4654,438,4712,31550,30685,865
6/4/2016 15:00,42540,4972,515,4712,32342,31443,899
6/4/2016 16:00,43484,4368,490,4712,33914,32297,1617
6/4/2016 17:00,44163,4412,412,4712,34627,31778,2849
6/4/2016 18:00,44191,3830,293,4712,35356,31369,3987
6/4/2016 19:00,43347,2192,122,4712,36321,31535,4786
6/4/2016 20:00,41755,1666,0,4712,35376,31280,4096
6/4/2016 21:00,40736,1108,0,4712,34916,29679,5237
6/4/2016 22:00,39947,1138,0,4712,34097,27479,6618
6/4/2016 23:00,37781,923,0,4712,32146,25178,6968
6/5/2016 0:00,35146,1265,0,4712,29169,23180,5989
6/5/2016 1:00,32648,1235,0,4712,26701,22026,4675
6/5/2016 2:00,30778,1208,0,4712,24858,21159,3699
6/5/2016 3:00,29427,1244,0,4712,23471,20486,2985
6/5/2016 4:00,28521,1386,0,4712,22422,20328,2094
6/5/2016 5:00,28062,1296,0,4712,22054,20065,1989
6/5/2016 6:00,28071,1401,1,4712,21957,20967,990
6/5/2016 7:00,28046,1247,146,4712,21940,23629,-1689
6/5/2016 8:00,28972,1064,240,4712,22955,26284,-3329
6/5/2016 9:00,31712,1182,290,4712,25528,28695,-3167
6/5/2016 10:00,34857,1913,350,4712,27882,29928,-2046
6/5/2016 11:00,37723,2671,506,4712,29834,31207,-1373
6/5/2016 12:00,40162,3395,516,4712,31539,32308,-769
6/5/2016 13:00,42074,3405,515,4712,33442,33820,-378
6/5/2016 14:00,43659,3010,509,4712,35428,35074,354
6/5/2016 15:00,45004,2606,514,4712,37172,35703,1469
6/5/2016 16:00,45932,2562,487,4712,38171,35824,2347
6/5/2016 17:00,46644,2501,433,4712,38997,35454,3543
6/5/2016 18:00,46740,1910,338,4712,39780,34172,5608
6/5/2016 19:00,45821,2087,130,4712,38892,32847,6045
6/5/2016 20:00,44309,2172,0,4712,37424,31567,5857
6/5/2016 21:00,42915,2823,0,4712,35380,28532,6848
6/5/2016 22:00,42100,3034,0,4712,34353,25155,9198
6/5/2016 23:00,39259,3171,0,4712,31376,22804,8572
6/6/2016 0:00,35662,3021,0,4712,27928,21179,6749
6/6/2016 1:00,32563,2473,0,4712,25378,20400,4978
6/6/2016 2:00,30411,2046,0,4712,23653,20273,3380
6/6/2016 3:00,29157,1771,0,4712,22675,20781,1894
6/6/2016 4:00,28568,1296,0,4712,22560,22430,130
6/6/2016 5:00,28782,1183,0,4712,22887,24519,-1632
6/6/2016 6:00,30257,1205,21,4712,24319,26358,-2039
6/6/2016 7:00,32281,826,237,4712,26506,28231,-1725
6/6/2016 8:00,33942,433,358,4712,28440,30773,-2333
6/6/2016 9:00,36180,378,412,4712,30678,32974,-2296
6/6/2016 10:00,38808,522,475,4712,33099,35395,-2296
6/6/2016 11:00,41598,678,506,4712,35701,37733,-2032
6/6/2016 12:00,44293,740,518,4712,38323,39899,-1576
6/6/2016 13:00,46845,699,517,4712,40917,41574,-657
6/6/2016 14:00,49274,704,509,4712,43348,43227,121
6/6/2016 15:00,51295,717,492,4712,45374,43863,1511
6/6/2016 16:00,53004,788,496,4712,47007,43839,3168
6/6/2016 17:00,53935,766,452,4712,48005,43745,4260
6/6/2016 18:00,54155,861,355,4712,48227,41833,6394
6/6/2016 19:00,53115,1029,206,4712,47168,39653,7515
6/6/2016 20:00,51051,1395,0,4712,44945,37395,7550
6/6/2016 21:00,49025,2199,0,4712,42114,33210,8904
6/6/2016 22:00,47368,2975,0,4712,39680,28737,10943
6/6/2016 23:00,43542,3058,0,4712,35772,25806,9966
6/7/2016 0:00,39179,3165,0,4712,31302,23747,7555
6/7/2016 1:00,35598,3304,0,4712,27582,22097,5485
6/7/2016 2:00,33149,3168,0,4712,25269,21890,3379
6/7/2016 3:00,31528,1860,0,4712,24956,22547,2409
6/7/2016 4:00,30507,1447,0,4712,24348,24294,54
6/7/2016 5:00,30477,790,0,4712,24975,26370,-1395
6/7/2016 6:00,31764,681,16,4712,26355,27860,-1505
6/7/2016 7:00,33523,562,159,4712,28090,30231,-2141
6/7/2016 8:00,35373,183,339,4712,30139,33196,-3057
6/7/2016 9:00,38029,199,386,4712,32732,36334,-3602
6/7/2016 10:00,41309,250,417,4712,35929,39342,-3413
6/7/2016 11:00,45048,447,483,4712,39406,41634,-2228
6/7/2016 12:00,48310,602,521,4712,42475,43493,-1018
6/7/2016 13:00,50890,816,515,4712,44847,45136,-289
6/7/2016 14:00,53313,1222,485,4712,46894,46127,767
6/7/2016 15:00,55284,1896,472,4712,48204,46082,2122
6/7/2016 16:00,56651,2618,428,4712,48893,45330,3563
6/7/2016 17:00,57223,3074,365,4712,49072,44015,5057
6/7/2016 18:00,56926,3125,312,4712,48777,42040,6737
6/7/2016 19:00,55548,3446,198,4712,47192,39922,7270
6/7/2016 20:00,53427,3823,0,4712,44892,37497,7395
6/7/2016 21:00,51319,4546,0,4712,42061,32955,9106
6/7/2016 22:00,49339,4898,0,4712,39729,28815,10914
6/7/2016 23:00,45339,4786,0,4712,35840,25578,10262
6/8/2016 0:00,40744,4910,0,4712,31122,23075,8047
6/8/2016 1:00,37057,5491,0,4712,26853,20874,5979
6/8/2016 2:00,34508,5885,0,4712,23911,19537,4374
6/8/2016 3:00,32860,6128,0,4712,22020,19184,2836
6/8/2016 4:00,31944,6666,0,4712,20566,20674,-108
6/8/2016 5:00,31882,5539,0,4712,21631,23320,-1689
6/8/2016 6:00,33114,4975,2,4712,23425,25433,-2008
6/8/2016 7:00,34937,4253,197,4712,25775,28564,-2789
6/8/2016 8:00,36731,3395,238,4712,28386,31373,-2987
6/8/2016 9:00,39538,3636,280,4712,30910,34887,-3977
6/8/2016 10:00,42906,2946,418,4712,34830,38695,-3865
6/8/2016 11:00,46617,2331,485,4712,39088,41121,-2033
6/8/2016 12:00,49891,2300,494,4712,42385,42553,-168
6/8/2016 13:00,52541,3023,414,4712,44391,43711,680
6/8/2016 14:00,54787,3697,467,4712,45910,44328,1582
6/8/2016 15:00,56577,4598,480,4712,46787,44174,2613
6/8/2016 16:00,57909,5544,428,4712,47225,43179,4046
6/8/2016 17:00,58558,6217,380,4712,47249,41039,6210
6/8/2016 18:00,58184,6592,296,4712,46584,39174,7410
6/8/2016 19:00,56550,6377,252,4712,45208,37659,7549
6/8/2016 20:00,54045,6317,0,4712,43016,35253,7763
6/8/2016 21:00,51832,7515,0,4712,39605,30709,8896
6/8/2016 22:00,49963,7958,0,4712,37292,27041,10251
6/8/2016 23:00,46182,8153,0,4712,33318,23912,9406
6/9/2016 0:00,41836,7693,0,4712,29431,21984,7447
6/9/2016 1:00,38235,7858,0,4712,25665,20100,5565
6/9/2016 2:00,35759,7899,0,4712,23148,18895,4253
6/9/2016 3:00,34060,7605,0,4712,21743,19416,2327
6/9/2016 4:00,32984,6997,0,4712,21275,20721,554
6/9/2016 5:00,32889,7069,0,4712,21108,22351,-1243
6/9/2016 6:00,34061,6761,15,4712,22573,24767,-2194
6/9/2016 7:00,35902,5514,158,4712,25517,27858,-2341
6/9/2016 8:00,37682,6360,322,4712,26288,30929,-4641
6/9/2016 9:00,40714,6109,447,4712,29446,34564,-5118
6/9/2016 10:00,44348,5421,502,4712,33713,37912,-4199
6/9/2016 11:00,47996,5407,506,4712,37370,39754,-2384
6/9/2016 12:00,51277,5666,502,4712,40396,41615,-1219
6/9/2016 13:00,53984,5935,522,4712,42815,42421,394
6/9/2016 14:00,56291,6399,500,4712,44680,42586,2094
6/9/2016 15:00,57607,6911,495,4712,45489,42234,3255
6/9/2016 16:00,58077,7561,474,4712,45331,40774,4557
6/9/2016 17:00,58138,8381,420,4712,44625,38553,6072
6/9/2016 18:00,57319,9326,326,4712,42956,36907,6049
6/9/2016 19:00,55580,8966,259,4712,41643,35734,5909
6/9/2016 20:00,53617,7967,0,4712,40938,34639,6299
6/9/2016 21:00,51650,8180,0,4712,38758,30605,8153
6/9/2016 22:00,50162,8346,0,4712,37104,26899,10205
6/9/2016 23:00,46429,7762,0,4712,33955,25029,8926
6/10/2016 0:00,42288,6394,0,4712,31182,23531,7651
6/10/2016 1:00,38767,5941,0,4712,28115,21689,6426
6/10/2016 2:00,36239,6795,0,4712,24732,20288,4444
6/10/2016 3:00,34567,6836,0,4712,23019,19881,3138
6/10/2016 4:00,33589,6877,0,4712,22000,21434,566
6/10/2016 5:00,33362,6604,0,4712,22046,23046,-1000
6/10/2016 6:00,34443,6301,31,4712,23399,25328,-1929
6/10/2016 7:00,35914,5306,308,4712,25588,28544,-2956
6/10/2016 8:00,37668,4903,448,4712,27605,31269,-3664
6/10/2016 9:00,40472,5570,460,4712,29729,34274,-4545
6/10/2016 10:00,43752,5253,495,4712,33293,37693,-4400
6/10/2016 11:00,47376,4514,518,4712,37632,40692,-3060
6/10/2016 12:00,50519,4241,520,4712,41047,42339,-1292
6/10/2016 13:00,53077,5119,523,4712,42724,43609,-885
6/10/2016 14:00,55429,5752,520,4712,44445,44349,96
6/10/2016 15:00,57271,6335,505,4712,45719,44348,1371
6/10/2016 16:00,58569,6490,476,4712,46892,43591,3301
6/10/2016 17:00,58939,7127,422,4712,46678,41891,4787
6/10/2016 18:00,58344,7056,384,4712,46192,39640,6552
6/10/2016 19:00,56759,6943,242,4712,44861,37975,6886
6/10/2016 20:00,54413,6544,0,4712,43158,36199,6959
6/10/2016 21:00,52374,7056,0,4712,40606,32720,7886
6/10/2016 22:00,50755,7887,0,4712,38157,29001,9156
6/10/2016 23:00,47549,8203,0,4712,34633,25605,9028
6/11/2016 0:00,44062,8647,0,4712,30702,23246,7456
6/11/2016 1:00,40734,8598,0,4712,27424,22163,5261
6/11/2016 2:00,38280,7828,0,4712,25740,21492,4248
6/11/2016 3:00,36422,7286,0,4712,24424,21204,3220
6/11/2016 4:00,35187,6618,0,4712,23857,21922,1935
6/11/2016 5:00,34616,6113,0,4712,23791,22303,1488
6/11/2016 6:00,34692,6206,1,4712,23773,23737,36
6/11/2016 7:00,34935,5799,145,4712,24279,25899,-1620
6/11/2016 8:00,36166,7013,238,4712,24203,28382,-4179
6/11/2016 9:00,39222,7141,277,4712,27092,31246,-4154
6/11/2016 10:00,42583,7223,396,4712,30251,34219,-3968
6/11/2016 11:00,46208,6997,508,4712,33991,37049,-3058
6/11/2016 12:00,49426,7108,517,4712,37088,38374,-1286
6/11/2016 13:00,51981,6141,511,4712,40617,39739,878
6/11/2016 14:00,53625,5789,467,4712,42657,40218,2439
6/11/2016 15:00,54458,6352,502,4712,42892,39962,2930
6/11/2016 16:00,55092,7025,476,4712,42878,39331,3547
6/11/2016 17:00,55280,7477,330,4712,42762,38497,4265
6/11/2016 18:00,54805,7550,303,4712,42239,37122,5117
6/11/2016 19:00,53538,6744,184,4712,41898,36188,5710
6/11/2016 20:00,51873,6510,0,4712,40652,34870,5782
6/11/2016 21:00,50530,7031,0,4712,38786,32422,6364
6/11/2016 22:00,49572,6954,0,4712,37905,29235,8670
6/11/2016 23:00,47076,6973,0,4712,35391,26725,8666
6/12/2016 0:00,44136,6363,0,4712,33061,25437,7624
6/12/2016 1:00,41222,5876,0,4712,30635,24927,5708
6/12/2016 2:00,39004,4688,0,4712,29603,24699,4904
6/12/2016 3:00,37372,4474,0,4712,28186,23976,4210
6/12/2016 4:00,36246,4557,0,4712,26977,24537,2440
6/12/2016 5:00,35511,3989,0,4712,26810,24913,1897
6/12/2016 6:00,35420,3539,0,4712,27168,25860,1308
6/12/2016 7:00,35346,3076,135,4712,27423,28026,-603
6/12/2016 8:00,35936,3179,250,4712,27794,30297,-2503
6/12/2016 9:00,38448,3589,336,4712,29811,32168,-2357
6/12/2016 10:00,41609,3637,459,4712,32801,34861,-2060
6/12/2016 11:00,44503,3458,512,4712,35821,37546,-1725
6/12/2016 12:00,47165,3346,509,4712,38598,39206,-608
6/12/2016 13:00,49913,3022,503,4712,41677,40227,1450
6/12/2016 14:00,51597,3198,509,4712,43178,40235,2943
6/12/2016 15:00,52611,3635,494,4712,43769,39095,4674
6/12/2016 16:00,52509,3723,442,4712,43632,37891,5741
6/12/2016 17:00,51320,3718,412,4712,42478,36587,5891
6/12/2016 18:00,49886,4325,311,4712,40537,35130,5407
6/12/2016 19:00,48506,4531,258,4712,39005,33876,5129
6/12/2016 20:00,47166,5600,0,4712,36855,32356,4499
6/12/2016 21:00,46344,6810,0,4712,34822,29474,5348
6/12/2016 22:00,46068,7690,0,4712,33667,26018,7649
6/12/2016 23:00,43704,7996,0,4712,30996,23545,7451
6/13/2016 0:00,40467,8181,0,4712,27574,21589,5985
6/13/2016 1:00,37739,8141,0,4712,24886,20620,4266
6/13/2016 2:00,35818,7738,0,4712,23368,20584,2784
6/13/2016 3:00,34693,7180,0,4712,22800,21253,1547
6/13/2016 4:00,34191,6883,0,4712,22595,22983,-388
6/13/2016 5:00,34521,6302,0,4712,23507,25899,-2392
6/13/2016 6:00,36109,5877,1,4712,25519,27593,-2074
6/13/2016 7:00,38244,5135,158,4712,28240,29651,-1411
6/13/2016 8:00,39652,5430,226,4712,29284,31808,-2524
6/13/2016 9:00,41932,6007,323,4712,30890,35539,-4649
6/13/2016 10:00,44959,5149,425,4712,34673,39009,-4336
6/13/2016 11:00,48412,4836,483,4712,38381,42029,-3648
6/13/2016 12:00,51748,3536,509,4712,42990,44594,-1604
6/13/2016 13:00,54599,3895,443,4712,45549,45081,468
6/13/2016 14:00,57066,3855,502,4712,47997,44759,3238
6/13/2016 15:00,57562,4368,494,4712,47987,44345,3642
6/13/2016 16:00,57241,5231,446,4712,46853,43077,3776
6/13/2016 17:00,57200,6175,360,4712,45953,41450,4503
6/13/2016 18:00,56523,6822,272,4712,44716,39369,5347
6/13/2016 19:00,55339,7134,169,4712,43323,38104,5219
6/13/2016 20:00,53805,7477,0,4712,41616,36162,5454
6/13/2016 21:00,52456,8946,0,4712,38797,31657,7140
6/13/2016 22:00,51324,9867,0,4712,36745,27332,9413
6/13/2016 23:00,47871,10150,0,4712,33009,24134,8875
6/14/2016 0:00,43904,9711,0,4712,29481,22276,7205
6/14/2016 1:00,40477,9210,0,4712,26555,21239,5316
6/14/2016 2:00,38200,7925,0,4712,25563,21231,4332
6/14/2016 3:00,36497,7872,0,4712,23913,21284,2629
6/14/2016 4:00,35637,8108,0,4712,22817,23088,-271
6/14/2016 5:00,35599,6406,0,4712,24481,26641,-2160
6/14/2016 6:00,36861,3996,2,4712,28152,29449,-1297
6/14/2016 7:00,38649,3837,61,4712,30039,31211,-1172
6/14/2016 8:00,40193,4225,220,4712,31036,33244,-2208
6/14/2016 9:00,42538,4810,354,4712,32662,36463,-3801
6/14/2016 10:00,45374,4060,465,4712,36137,39623,-3486
6/14/2016 11:00,48615,4217,495,4712,39191,41967,-2776
6/14/2016 12:00,51559,4659,504,4712,41684,43987,-2303
6/14/2016 13:00,54188,4981,494,4712,44000,45897,-1897
6/14/2016 14:00,56802,5164,469,4712,46457,47117,-660
6/14/2016 15:00,58979,5252,472,4712,48543,47908,635
6/14/2016 16:00,60642,5209,447,4712,50274,47900,2374
6/14/2016 17:00,61476,5825,444,4712,50495,46265,4230
6/14/2016 18:00,61456,6575,362,4712,49806,44095,5711
6/14/2016 19:00,60331,6175,228,4712,49215,42320,6895
6/14/2016 20:00,58278,6473,0,4712,47093,39679,7414
6/14/2016 21:00,56173,7894,0,4712,43567,34533,9034
6/14/2016 22:00,54452,9169,0,4712,40571,29379,11192
6/14/2016 23:00,50637,10617,0,4712,35308,25748,9560
6/15/2016 0:00,46133,10744,0,4712,30678,23831,6847
6/15/2016 1:00,42529,10226,0,4712,27591,22581,5010
6/15/2016 2:00,40129,9826,0,4712,25590,22036,3554
6/15/2016 3:00,38511,9610,0,4712,24189,22108,2081
6/15/2016 4:00,37642,9136,0,4712,23794,23943,-149
6/15/2016 5:00,37475,8161,0,4712,24602,26218,-1616
6/15/2016 6:00,38640,7599,0,4712,26329,28027,-1698
6/15/2016 7:00,40426,6217,133,4712,29363,31053,-1690
6/15/2016 8:00,41909,6425,240,4712,30532,33674,-3142
6/15/2016 9:00,44420,6413,365,4712,32929,37902,-4973
6/15/2016 10:00,47855,6036,464,4712,36643,41782,-5139
6/15/2016 11:00,51619,5138,501,4712,41268,44894,-3626
6/15/2016 12:00,55148,5008,505,4712,44923,47112,-2189
6/15/2016 13:00,58172,5437,503,4712,47519,48805,-1286
6/15/2016 14:00,60810,5777,503,4712,49817,49234,583
6/15/2016 15:00,62994,6642,489,4712,51151,48661,2490
6/15/2016 16:00,64268,8045,448,4712,51064,47377,3687
6/15/2016 17:00,64876,9465,416,4712,50283,45300,4983
6/15/2016 18:00,64672,9736,282,4712,49942,43248,6694
6/15/2016 19:00,63318,8521,140,4712,49945,41497,8448
6/15/2016 20:00,60785,8844,0,4712,47229,39337,7892
6/15/2016 21:00,58069,9595,0,4712,43762,34407,9355
6/15/2016 22:00,55970,10819,0,4712,40439,30177,10262
6/15/2016 23:00,51821,8812,0,4712,38297,28843,9454
6/16/2016 0:00,47320,6942,0,4712,35666,26987,8679
6/16/2016 1:00,43570,6442,0,4712,32417,25318,7099
6/16/2016 2:00,40832,7455,0,4712,28665,23359,5306
6/16/2016 3:00,38837,8061,0,4712,26064,22288,3776
6/16/2016 4:00,37719,8919,0,4712,24087,23414,673
6/16/2016 5:00,37525,8589,0,4712,24223,25802,-1579
6/16/2016 6:00,38653,7451,0,4712,26490,27851,-1361
6/16/2016 7:00,40381,6082,115,4712,29473,30966,-1493
6/16/2016 8:00,42023,6521,229,4712,30562,33505,-2943
6/16/2016 9:00,44748,7021,329,4712,32685,37726,-5041
6/16/2016 10:00,48329,5984,461,4712,37172,41760,-4588
6/16/2016 11:00,52188,5397,472,4712,41607,44721,-3114
6/16/2016 12:00,55762,5559,465,4712,45027,46619,-1592
6/16/2016 13:00,58707,5862,445,4712,47687,48023,-336
6/16/2016 14:00,61381,6181,413,4712,50076,48440,1636
6/16/2016 15:00,63442,6826,401,4712,51504,48590,2914
6/16/2016 16:00,64496,7093,347,4712,52345,48236,4109
6/16/2016 17:00,64733,7625,311,4712,52086,46829,5257
6/16/2016 18:00,64488,8363,289,4712,51124,44401,6723
6/16/2016 19:00,63241,8067,188,4712,50275,41905,8370
6/16/2016 20:00,61001,8992,0,4712,47298,38865,8433
6/16/2016 21:00,58434,11301,0,4712,42421,32959,9462
6/16/2016 22:00,56511,12327,0,4712,39472,28803,10669
6/16/2016 23:00,52440,12206,0,4712,35521,25782,9739
6/17/2016 0:00,48190,11753,0,4712,31724,23560,8164
6/17/2016 1:00,44302,11309,0,4712,28282,22183,6099
6/17/2016 2:00,41606,10617,0,4712,26278,21879,4399
6/17/2016 3:00,39625,9209,0,4712,25703,22262,3441
6/17/2016 4:00,38374,9003,0,4712,24659,23030,1629
6/17/2016 5:00,37934,8914,0,4712,24309,24415,-106
6/17/2016 6:00,38645,8883,9,4712,25041,26291,-1250
6/17/2016 7:00,39831,7273,218,4712,27628,29729,-2101
6/17/2016 8:00,41251,7210,363,4712,28966,32965,-3999
6/17/2016 9:00,44153,6040,435,4712,32966,38115,-5149
6/17/2016 10:00,47482,4164,444,4712,38161,43230,-5069
6/17/2016 11:00,51206,2895,500,4712,43100,46716,-3616
6/17/2016 12:00,54836,2214,505,4712,47406,49187,-1781
6/17/2016 13:00,57998,2204,465,4712,50616,51178,-562
6/17/2016 14:00,61016,2775,477,4712,53051,51850,1201
6/17/2016 15:00,63243,3612,394,4712,54524,51323,3201
6/17/2016 16:00,64480,4084,403,4712,55281,50788,4493
6/17/2016 17:00,64842,4554,377,4712,55199,49579,5620
6/17/2016 18:00,64575,5015,286,4712,54563,46998,7565
6/17/2016 19:00,63296,5689,161,4712,52734,43355,9379
6/17/2016 20:00,60911,7431,0,4712,48768,39748,9020
6/17/2016 21:00,58256,9443,0,4712,44102,34859,9243
6/17/2016 22:00,56235,9985,0,4712,41538,30829,10709
6/17/2016 23:00,52615,10056,0,4712,37847,27728,10119
6/18/2016 0:00,48643,9699,0,4712,34233,25200,9033
6/18/2016 1:00,44969,9554,0,4712,30703,23590,7113
6/18/2016 2:00,42042,9686,0,4712,27644,21980,5664
6/18/2016 3:00,39830,9446,0,4712,25672,21717,3955
6/18/2016 4:00,38306,8561,0,4712,25033,22579,2454
6/18/2016 5:00,37416,7472,0,4712,25232,23879,1353
6/18/2016 6:00,37245,6294,7,4712,26232,25963,269
6/18/2016 7:00,37203,4650,182,4712,27658,29828,-2170
6/18/2016 8:00,38394,4656,272,4712,28755,33631,-4876
6/18/2016 9:00,41973,3709,377,4712,33175,38754,-5579
6/18/2016 10:00,46019,2438,391,4712,38478,42961,-4483
6/18/2016 11:00,50082,1738,480,4712,43152,46215,-3063
6/18/2016 12:00,53883,1433,497,4712,47241,48553,-1312
6/18/2016 13:00,56969,1529,496,4712,50233,49772,461
6/18/2016 14:00,59298,1945,472,4712,52169,50671,1498
6/18/2016 15:00,61036,2165,460,4712,53698,50515,3183
6/18/2016 16:00,62224,2611,396,4712,54505,49917,4588
6/18/2016 17:00,62640,2893,367,4712,54668,47702,6966
6/18/2016 18:00,61856,3959,326,4712,52859,44292,8567
6/18/2016 19:00,59756,4718,236,4712,50090,41700,8390
6/18/2016 20:00,57063,4813,0,4712,47538,39394,8144
6/18/2016 21:00,54730,5575,0,4712,44444,35621,8823
6/18/2016 22:00,53050,5895,0,4712,42443,32212,10231
6/18/2016 23:00,49884,5876,0,4712,39296,29178,10118
6/19/2016 0:00,46454,5731,0,4712,36011,27196,8815
6/19/2016 1:00,42974,5424,0,4712,32838,25476,7362
6/19/2016 2:00,40149,5083,0,4712,30354,24639,5715
6/19/2016 3:00,37983,4546,0,4712,28725,24365,4360
6/19/2016 4:00,36471,3998,0,4712,27760,24305,3455
6/19/2016 5:00,35363,3914,0,4712,26736,23883,2853
6/19/2016 6:00,34824,4479,0,4712,25632,24214,1418
6/19/2016 7:00,34379,3637,144,4712,25887,27892,-2005
6/19/2016 8:00,35182,2429,265,4712,27777,31415,-3638
6/19/2016 9:00,38070,1952,309,4712,31097,35180,-4083
6/19/2016 10:00,41670,1973,410,4712,34575,38407,-3832
6/19/2016 11:00,45323,1358,484,4712,38769,41401,-2632
6/19/2016 12:00,48679,1316,483,4712,42168,43158,-990
6/19/2016 13:00,51612,1596,472,4712,44832,43655,1177
6/19/2016 14:00,53683,2684,461,4712,45826,44145,1681
6/19/2016 15:00,55259,3283,411,4712,46853,44335,2518
6/19/2016 16:00,56300,3855,409,4712,47324,43912,3412
6/19/2016 17:00,56921,4826,360,4712,47023,42513,4510
6/19/2016 18:00,56988,5215,264,4712,46797,40930,5867
6/19/2016 19:00,56211,5075,149,4712,46275,39171,7104
6/19/2016 20:00,54497,5165,0,4712,44620,37595,7025
6/19/2016 21:00,52579,5406,0,4712,42461,34028,8433
6/19/2016 22:00,51256,6341,0,4712,40203,30215,9988
6/19/2016 23:00,48217,5954,0,4712,37551,27122,10429
6/20/2016 0:00,44191,6335,0,4712,33144,25025,8119
6/20/2016 1:00,40600,6245,0,4712,29643,23721,5922
6/20/2016 2:00,38138,6101,0,4712,27325,23577,3748
6/20/2016 3:00,36528,5328,0,4712,26488,24170,2318
6/20/2016 4:00,35613,4544,0,4712,26357,25470,887
6/20/2016 5:00,35529,4343,0,4712,26475,27439,-964
6/20/2016 6:00,36757,3403,0,4712,28642,29812,-1170
6/20/2016 7:00,38389,2303,152,4712,31221,33099,-1878
6/20/2016 8:00,40364,2485,228,4712,32939,35996,-3057
6/20/2016 9:00,43518,2656,317,4712,35833,40054,-4221
6/20/2016 10:00,47242,2017,363,4712,40149,43121,-2972
6/20/2016 11:00,51023,1906,433,4712,43971,45620,-1649
6/20/2016 12:00,54277,2003,419,4712,47144,47396,-252
6/20/2016 13:00,57041,2577,382,4712,49371,48459,912
6/20/2016 14:00,59394,2976,338,4712,51368,49290,2078
6/20/2016 15:00,61056,3441,326,4712,52577,49380,3197
6/20/2016 16:00,61983,3333,310,4712,53628,49215,4413
6/20/2016 17:00,62028,3367,286,4712,53663,47803,5860
6/20/2016 18:00,61276,3440,199,4712,52925,45535,7390
6/20/2016 19:00,59529,3086,114,4712,51617,44096,7521
6/20/2016 20:00,57420,3155,0,4712,49553,42054,7499
6/20/2016 21:00,55421,4057,0,4712,46652,37580,9072
6/20/2016 22:00,53838,4682,0,4712,44443,32978,11465
6/20/2016 23:00,50055,4707,0,4712,40636,29848,10788
6/21/2016 0:00,45675,4704,0,4712,36259,27464,8795
6/21/2016 1:00,42019,4719,0,4712,32589,26212,6377
6/21/2016 2:00,39432,4717,0,4712,30003,25584,4419
6/21/2016 3:00,37703,4681,0,4712,28310,25655,2655
6/21/2016 4:00,36639,4524,0,4712,27403,26312,1091
6/21/2016 5:00,36471,4507,0,4712,27252,27423,-171
6/21/2016 6:00,37601,4617,1,4712,28270,29387,-1117
6/21/2016 7:00,39118,3616,152,4712,30639,32333,-1694
6/21/2016 8:00,40948,3886,277,4712,32073,34818,-2745
6/21/2016 9:00,44075,3967,351,4712,35045,39502,-4457
6/21/2016 10:00,47723,2680,441,4712,39890,43740,-3850
6/21/2016 11:00,51699,2025,462,4712,44500,46053,-1553
6/21/2016 12:00,55093,2364,499,4712,47517,47940,-423
6/21/2016 13:00,57780,2790,499,4712,49779,49253,526
6/21/2016 14:00,60170,3027,484,4712,51948,49876,2072
6/21/2016 15:00,61702,3540,494,4712,52956,49642,3314
6/21/2016 16:00,62437,3788,467,4712,53470,48791,4679
6/21/2016 17:00,62438,4464,380,4712,52882,47224,5658
6/21/2016 18:00,61741,4985,270,4712,51774,44807,6967
6/21/2016 19:00,60530,5336,152,4712,50330,42666,7664
6/21/2016 20:00,58666,5706,0,4712,48248,40203,8045
6/21/2016 21:00,56480,7206,0,4712,44562,34745,9817
6/21/2016 22:00,54937,8668,0,4712,41557,29730,11827
6/21/2016 23:00,51267,9301,0,4712,37254,26330,10924
6/22/2016 0:00,46897,9842,0,4712,32343,23928,8415
6/22/2016 1:00,43324,9895,0,4712,28717,22659,6058
6/22/2016 2:00,40832,9778,0,4712,26342,21632,4710
6/22/2016 3:00,39081,10097,0,4712,24273,21140,3133
6/22/2016 4:00,38019,10219,0,4712,23087,22274,813
6/22/2016 5:00,37824,9629,0,4712,23482,24250,-768
6/22/2016 6:00,38956,8976,0,4712,25268,26444,-1176
6/22/2016 7:00,40545,7693,115,4712,28026,28989,-963
6/22/2016 8:00,42062,8313,190,4712,28847,31199,-2352
6/22/2016 9:00,44816,9173,315,4712,30617,34750,-4133
6/22/2016 10:00,48288,8559,442,4712,34576,38495,-3919
6/22/2016 11:00,51947,8192,477,4712,38567,41074,-2507
6/22/2016 12:00,55206,7857,484,4712,42153,43188,-1035
6/22/2016 13:00,57891,7743,442,4712,44994,45043,-49
6/22/2016 14:00,60355,7367,433,4712,47843,46386,1457
6/22/2016 15:00,62249,7411,431,4712,49695,47186,2509
6/22/2016 16:00,63683,7585,407,4712,50980,46764,4216
6/22/2016 17:00,64318,8238,339,4712,51029,44929,6100
6/22/2016 18:00,63792,8755,311,4712,50014,43004,7010
6/22/2016 19:00,62206,8846,174,4712,48475,40283,8192
6/22/2016 20:00,59945,9530,0,4712,45703,37047,8656
6/22/2016 21:00,57546,11114,0,4712,41720,31570,10150
6/22/2016 22:00,55849,11361,0,4712,39776,27941,11835
6/22/2016 23:00,51886,11487,0,4712,35687,25409,10278
6/23/2016 0:00,47634,10726,0,4712,32196,23591,8605
6/23/2016 1:00,44053,10499,0,4712,28842,22457,6385
6/23/2016 2:00,41486,9774,0,4712,27000,22284,4716
6/23/2016 3:00,39571,8587,0,4712,26271,22800,3471
6/23/2016 4:00,38260,7774,0,4712,25774,24143,1631
6/23/2016 5:00,37920,6809,0,4712,26399,25716,683
6/23/2016 6:00,38814,6222,0,4712,27880,27613,267
6/23/2016 7:00,40199,4609,110,4712,30768,30960,-192
6/23/2016 8:00,41694,4900,193,4712,31889,33657,-1768
6/23/2016 9:00,44579,5206,342,4712,34318,37495,-3177
6/23/2016 10:00,47914,4253,410,4712,38539,41154,-2615
6/23/2016 11:00,51482,3901,461,4712,42408,44133,-1725
6/23/2016 12:00,54699,4225,474,4712,45289,46301,-1012
6/23/2016 13:00,57629,4684,482,4712,47751,47159,592
6/23/2016 14:00,60268,5185,469,4712,49902,48248,1654
6/23/2016 15:00,62274,5366,457,4712,51739,48110,3629
6/23/2016 16:00,63396,5999,424,4712,52261,47966,4295
6/23/2016 17:00,63882,6697,439,4712,52035,45447,6588
6/23/2016 18:00,63226,7473,343,4712,50698,42338,8360
6/23/2016 19:00,61312,7771,194,4712,48635,39840,8795
6/23/2016 20:00,58742,8028,0,4712,46002,37447,8555
6/23/2016 21:00,56316,9575,0,4712,42029,32486,9543
6/23/2016 22:00,54717,10441,0,4712,39564,28340,11224
6/23/2016 23:00,50851,10455,0,4712,35684,25549,10135
6/24/2016 0:00,46494,9944,0,4712,31838,24047,7791
6/24/2016 1:00,42691,9399,0,4712,28581,22847,5734
6/24/2016 2:00,39986,8600,0,4712,26675,22898,3777
6/24/2016 3:00,38117,7045,0,4712,26360,23699,2661
6/24/2016 4:00,36936,6761,0,4712,25463,24761,702
6/24/2016 5:00,36582,5777,0,4712,26093,26011,82
6/24/2016 6:00,37450,5814,1,4712,26924,27519,-595
6/24/2016 7:00,38778,4991,81,4712,28995,30444,-1449
6/24/2016 8:00,40471,5419,206,4712,30134,33593,-3459
6/24/2016 9:00,43529,5036,280,4712,33502,37588,-4086
6/24/2016 10:00,47033,4814,370,4712,37138,41489,-4351
6/24/2016 11:00,50818,4499,473,4712,41134,43751,-2617
6/24/2016 12:00,54098,4900,501,4712,43985,45170,-1185
6/24/2016 13:00,56820,6095,498,4712,45515,45413,102
6/24/2016 14:00,59092,6701,460,4712,47220,44982,2238
6/24/2016 15:00,60215,7263,463,4712,47777,44699,3078
6/24/2016 16:00,60801,7559,454,4712,48075,43852,4223
6/24/2016 17:00,60820,8006,401,4712,47700,42016,5684
6/24/2016 18:00,60263,8325,373,4712,46853,39924,6929
6/24/2016 19:00,58841,7763,241,4712,46125,38232,7893
6/24/2016 20:00,56595,7571,0,4712,44312,36107,8205
6/24/2016 21:00,54299,9071,0,4712,40516,32044,8472
6/24/2016 22:00,52865,9870,0,4712,38283,28670,9613
6/24/2016 23:00,49789,9652,0,4712,35426,26112,9314
6/25/2016 0:00,46212,9554,0,4712,31946,24040,7906
6/25/2016 1:00,42855,9544,0,4712,28600,22951,5649
6/25/2016 2:00,40392,9230,0,4712,26450,22203,4247
6/25/2016 3:00,38603,8891,0,4712,25000,21593,3407
6/25/2016 4:00,37474,8920,0,4712,23842,21746,2096
6/25/2016 5:00,36897,8964,0,4712,23221,22081,1140
6/25/2016 6:00,36924,8575,1,4712,23636,23815,-179
6/25/2016 7:00,37068,8026,147,4712,24184,26334,-2150
6/25/2016 8:00,38306,9399,218,4712,23976,28486,-4510
6/25/2016 9:00,41600,9918,278,4712,26693,31822,-5129
6/25/2016 10:00,45495,9228,393,4712,31163,34697,-3534
6/25/2016 11:00,49048,9124,488,4712,34725,36451,-1726
6/25/2016 12:00,51897,9802,509,4712,36874,36818,56
6/25/2016 13:00,53757,9921,509,4712,38615,37794,821
6/25/2016 14:00,54734,9781,508,4712,39732,38402,1330
6/25/2016 15:00,55776,10433,496,4712,40135,37772,2363
6/25/2016 16:00,56642,10986,470,4712,40474,36213,4261
6/25/2016 17:00,56502,10769,421,4712,40601,35107,5494
6/25/2016 18:00,55355,10751,328,4712,39564,33343,6221
6/25/2016 19:00,53789,10879,264,4712,37933,32177,5756
6/25/2016 20:00,51967,10002,0,4712,37254,32214,5040
6/25/2016 21:00,50758,8777,0,4712,37269,30804,6465
6/25/2016 22:00,49720,7547,0,4712,37462,28945,8517
6/25/2016 23:00,47207,7527,0,4712,34968,27023,7945
6/26/2016 0:00,44206,6948,0,4712,32546,25780,6766
6/26/2016 1:00,41401,6569,0,4712,30120,25071,5049
6/26/2016 2:00,39304,5207,0,4712,29385,24620,4765
6/26/2016 3:00,37726,5158,0,4712,27856,23871,3985
6/26/2016 4:00,36565,5284,0,4712,26568,24133,2435
6/26/2016 5:00,35810,5031,0,4712,26067,24244,1823
6/26/2016 6:00,35633,4832,0,4712,26089,25058,1031
6/26/2016 7:00,35426,5061,152,4712,25501,27405,-1904
6/26/2016 8:00,36407,5689,283,4712,25723,29967,-4244
6/26/2016 9:00,39736,5816,377,4712,28830,34021,-5191
6/26/2016 10:00,43648,4772,474,4712,33690,37976,-4286
6/26/2016 11:00,47444,4964,500,4712,37268,41022,-3754
6/26/2016 12:00,50896,4394,511,4712,41279,43434,-2155
6/26/2016 13:00,53675,4099,508,4712,44356,44443,-87
6/26/2016 14:00,55845,5006,500,4712,45627,44715,912
6/26/2016 15:00,57289,5183,481,4712,46913,45014,1899
6/26/2016 16:00,58177,5880,428,4712,47157,44502,2655
6/26/2016 17:00,58693,5062,422,4712,48497,44738,3759
6/26/2016 18:00,58595,3986,317,4712,49579,44023,5556
6/26/2016 19:00,57460,3085,154,4712,49509,42681,6828
6/26/2016 20:00,55645,2515,0,4712,48418,41592,6826
6/26/2016 21:00,53804,2836,0,4712,46256,38276,7980
6/26/2016 22:00,52369,2749,0,4712,44908,33878,11030
6/26/2016 23:00,49103,3158,0,4712,41233,31358,9875
6/27/2016 0:00,45216,2689,0,4712,37815,29551,8264
6/27/2016 1:00,41806,2576,0,4712,34518,27932,6586
6/27/2016 2:00,39284,2746,0,4712,31826,27248,4578
6/27/2016 3:00,37618,2783,0,4712,30123,26920,3203
6/27/2016 4:00,36671,2708,0,4712,29252,28098,1154
6/27/2016 5:00,36581,2771,0,4712,29098,29634,-536
6/27/2016 6:00,37671,2178,1,4712,30780,31900,-1120
6/27/2016 7:00,39264,1486,151,4712,32915,35497,-2582
6/27/2016 8:00,41212,777,270,4712,35453,39456,-4003
6/27/2016 9:00,44463,883,363,4712,38506,43494,-4988
6/27/2016 10:00,48159,1022,408,4712,42018,46949,-4931
6/27/2016 11:00,52302,1136,467,4712,45986,49010,-3024
6/27/2016 12:00,56025,1507,489,4712,49318,50955,-1637
6/27/2016 13:00,58888,1817,472,4712,51887,51562,325
6/27/2016 14:00,61225,2146,461,4712,53906,51223,2683
6/27/2016 15:00,62543,2639,473,4712,54719,51155,3564
6/27/2016 16:00,62730,2883,418,4712,54716,50338,4378
6/27/2016 17:00,62587,2575,388,4712,54913,49445,5468
6/27/2016 18:00,61723,2250,231,4712,54530,47181,7349
6/27/2016 19:00,59925,2277,148,4712,52789,45565,7224
6/27/2016 20:00,57513,1811,0,4712,50990,43888,7102
6/27/2016 21:00,55367,1694,0,4712,48961,39998,8963
6/27/2016 22:00,53694,1800,0,4712,47181,35636,11545
6/27/2016 23:00,49747,1936,0,4712,43099,32332,10767
6/28/2016 0:00,45540,1899,0,4712,38929,30406,8523
6/28/2016 1:00,41982,1853,0,4712,35418,28651,6767
6/28/2016 2:00,39421,1728,0,4712,32981,28241,4740
6/28/2016 3:00,37669,1219,0,4712,31738,28295,3443
6/28/2016 4:00,36674,1137,0,4712,30825,29437,1388
6/28/2016 5:00,36451,750,0,4712,30988,31034,-46
6/28/2016 6:00,37523,645,1,4712,32164,32603,-439
6/28/2016 7:00,39241,653,207,4712,33668,35708,-2040
6/28/2016 8:00,41003,528,370,4712,35392,39398,-4006
6/28/2016 9:00,44259,698,459,4712,38391,43528,-5137
6/28/2016 10:00,48073,236,459,4712,42666,46824,-4158
6/28/2016 11:00,52426,270,488,4712,46957,49376,-2419
6/28/2016 12:00,56512,692,500,4712,50608,50392,216
6/28/2016 13:00,59577,865,486,4712,53514,50520,2994
6/28/2016 14:00,61144,1208,458,4712,54766,48692,6074
6/28/2016 15:00,60835,2770,477,4712,52877,48157,4720
6/28/2016 16:00,59837,1880,412,4712,52833,46464,6369
6/28/2016 17:00,58929,2323,342,4712,51551,44612,6939
6/28/2016 18:00,57285,2184,311,4712,50079,42802,7277
6/28/2016 19:00,55049,2099,160,4712,48077,40713,7364
6/28/2016 20:00,52783,2834,0,4712,45238,38012,7226
6/28/2016 21:00,50982,4130,0,4712,42140,34344,7796
6/28/2016 22:00,49471,4046,0,4712,40713,30781,9932
6/28/2016 23:00,46110,4143,0,4712,37255,28389,8866
6/29/2016 0:00,41920,4194,0,4712,33014,25830,7184
6/29/2016 1:00,38640,3723,0,4712,30205,26056,4149
6/29/2016 2:00,36365,2481,0,4712,29172,25917,3255
6/29/2016 3:00,34949,2166,0,4712,28071,26276,1795
6/29/2016 4:00,34088,1773,0,4712,27603,27597,6
6/29/2016 5:00,34021,1549,0,4712,27760,29119,-1359
6/29/2016 6:00,35181,1489,0,4712,28980,30363,-1383
6/29/2016 7:00,37038,1264,146,4712,30916,33126,-2210
6/29/2016 8:00,38675,1016,296,4712,32650,35985,-3335
6/29/2016 9:00,41347,725,379,4712,35530,40157,-4627
6/29/2016 10:00,44770,274,452,4712,39333,44093,-4760
6/29/2016 11:00,48752,135,491,4712,43415,47148,-3733
6/29/2016 12:00,52460,164,499,4712,47085,49800,-2715
6/29/2016 13:00,55817,254,496,4712,50355,51191,-836
6/29/2016 14:00,58736,378,495,4712,53151,51998,1153
6/29/2016 15:00,60848,573,502,4712,55061,52681,2380
6/29/2016 16:00,62248,915,489,4712,56133,52261,3872
6/29/2016 17:00,62781,1598,430,4712,56040,50338,5702
6/29/2016 18:00,62318,2427,362,4712,54817,47521,7296
6/29/2016 19:00,60805,2934,217,4712,52943,44394,8549
6/29/2016 20:00,58459,3947,0,4712,49801,41371,8430
6/29/2016 21:00,55943,5153,0,4712,46079,35981,10098
6/29/2016 22:00,53961,5754,0,4712,43495,31699,11796
6/29/2016 23:00,49917,6040,0,4712,39165,28687,10478
6/30/2016 0:00,45484,5768,0,4712,35004,27146,7858
6/30/2016 1:00,41784,5019,0,4712,32053,25819,6234
6/30/2016 2:00,39051,5181,0,4712,29157,24671,4486
6/30/2016 3:00,37185,5802,0,4712,26671,24431,2240
6/30/2016 4:00,36140,5214,0,4712,26214,25986,228
6/30/2016 5:00,35988,4254,0,4712,27022,27879,-857
6/30/2016 6:00,37022,3643,1,4712,28667,30145,-1478
6/30/2016 7:00,38550,1917,149,4712,31772,33840,-2068
6/30/2016 8:00,40116,1313,224,4712,33867,37752,-3885
6/30/2016 9:00,43237,1170,280,4712,37074,41999,-4925
6/30/2016 10:00,47121,1088,446,4712,40875,45315,-4440
6/30/2016 11:00,51249,863,491,4712,45184,48476,-3292
6/30/2016 12:00,54853,543,499,4712,49099,51027,-1928
6/30/2016 13:00,57710,760,502,4712,51736,51555,181
6/30/2016 14:00,60458,1016,504,4712,54226,52545,1681
6/30/2016 15:00,62356,1805,490,4712,55348,51952,3396
6/30/2016 16:00,63498,2978,461,4712,55347,51634,3713
6/30/2016 17:00,64070,3135,413,4712,55809,50155,5654
6/30/2016 18:00,63554,3310,326,4712,55206,47794,7412
6/30/2016 19:00,62021,3778,269,4712,53262,44892,8370
6/30/2016 20:00,59771,4000,0,4712,51059,42663,8396
6/30/2016 21:00,57221,4766,0,4712,47743,38153,9590
6/30/2016 22:00,55262,5407,0,4712,45143,32815,12328
6/30/2016 23:00,51308,5505,0,4712,41091,29132,11959
7/1/2016 0:00,46820,5774,0,4712,36333,26666,9667
7/1/2016 1:00,42778,6166,0,4712,31900,25044,6856
7/1/2016 2:00,40062,6150,0,4712,29200,23846,5354
7/1/2016 3:00,38014,6463,0,4712,26839,23555,3284
7/1/2016 4:00,36722,6609,0,4712,25401,24351,1050
7/1/2016 5:00,36249,5844,0,4712,25693,25836,-143
7/1/2016 6:00,36968,5228,0,4712,27028,27718,-690
7/1/2016 7:00,38199,3893,135,4712,29460,31066,-1606
7/1/2016 8:00,39641,3979,240,4712,30710,34772,-4062
7/1/2016 9:00,43006,3225,295,4712,34774,39851,-5077
7/1/2016 10:00,46996,2115,392,4712,39777,44309,-4532
7/1/2016 11:00,51154,1426,486,4712,44529,47414,-2885
7/1/2016 12:00,54785,1760,510,4712,47803,49232,-1429
7/1/2016 13:00,57888,2634,510,4712,50032,49640,392
7/1/2016 14:00,60540,3984,505,4712,51339,49375,1964
7/1/2016 15:00,62431,4859,488,4712,52372,48999,3373
7/1/2016 16:00,63593,6426,492,4712,51963,47742,4221
7/1/2016 17:00,64205,7775,440,4712,51278,45186,6092
7/1/2016 18:00,63697,8491,355,4712,50139,42346,7793
7/1/2016 19:00,61894,8054,227,4712,48901,40348,8553
7/1/2016 20:00,59247,7484,0,4712,47051,38444,8607
7/1/2016 21:00,56684,8466,0,4712,43506,33669,9837
7/1/2016 22:00,55000,10174,0,4712,40114,29372,10742
7/1/2016 23:00,51572,10753,0,4712,36107,26607,9500
7/2/2016 0:00,47736,11016,0,4712,32008,24582,7426
7/2/2016 1:00,44197,10608,0,4712,28877,22961,5916
7/2/2016 2:00,41499,10833,0,4712,25954,21632,4322
7/2/2016 3:00,39489,10496,0,4712,24281,21327,2954
7/2/2016 4:00,38103,9915,0,4712,23476,21780,1696
7/2/2016 5:00,37313,9174,0,4712,23428,22126,1302
7/2/2016 6:00,37204,8438,0,4712,24053,24101,-48
7/2/2016 7:00,37084,7290,126,4712,24956,27203,-2247
7/2/2016 8:00,37988,8143,224,4712,24910,29867,-4957
7/2/2016 9:00,41372,8660,318,4712,27682,33635,-5953
7/2/2016 10:00,45493,7889,465,4712,32427,37871,-5444
7/2/2016 11:00,49514,7010,494,4712,37298,41050,-3752
7/2/2016 12:00,53100,6493,512,4712,41383,43296,-1913
7/2/2016 13:00,56040,6240,509,4712,44578,44706,-128
7/2/2016 14:00,58350,6711,502,4712,46425,45292,1133
7/2/2016 15:00,60175,7727,489,4712,47246,44652,2594
7/2/2016 16:00,61389,9071,453,4712,47153,43777,3376
7/2/2016 17:00,62007,10120,403,4712,46773,42073,4700
7/2/2016 18:00,61822,10369,363,4712,46378,40993,5385
7/2/2016 19:00,60617,10053,222,4712,45630,39029,6601
7/2/2016 20:00,58488,9726,0,4712,44050,37259,6791
7/2/2016 21:00,56193,10241,0,4712,41240,34284,6956
7/2/2016 22:00,54507,9912,0,4712,39883,31255,8628
7/2/2016 23:00,51557,10332,0,4712,36514,27568,8946
7/3/2016 0:00,48184,10841,0,4712,32631,25300,7331
7/3/2016 1:00,45034,11046,0,4712,29276,24095,5181
7/3/2016 2:00,42603,10404,0,4712,27487,23031,4456
7/3/2016 3:00,40797,10512,0,4712,25573,22387,3186
7/3/2016 4:00,39485,9952,0,4712,24820,22573,2247
7/3/2016 5:00,38682,9559,0,4712,24411,22319,2092
7/3/2016 6:00,38336,9485,0,4712,24139,23386,753
7/3/2016 7:00,38007,9028,78,4712,24190,25264,-1074
7/3/2016 8:00,38583,10169,215,4712,23487,28074,-4587
7/3/2016 9:00,41402,9366,369,4712,26955,32282,-5327
7/3/2016 10:00,45056,7845,437,4712,32062,36861,-4799
7/3/2016 11:00,48596,6093,481,4712,37310,41007,-3697
7/3/2016 12:00,51962,4830,506,4712,41913,44463,-2550
7/3/2016 13:00,54932,3837,458,4712,45925,46650,-725
7/3/2016 14:00,57501,3405,478,4712,48906,48215,691
7/3/2016 15:00,59570,3278,469,4712,51111,48835,2276
7/3/2016 16:00,60989,3377,426,4712,52473,48822,3651
7/3/2016 17:00,61847,3700,402,4712,53032,47490,5542
7/3/2016 18:00,61816,4390,313,4712,52401,45330,7071
7/3/2016 19:00,60667,4745,251,4712,50959,43319,7640
7/3/2016 20:00,58544,5043,0,4712,48789,40679,8110
7/3/2016 21:00,56377,5801,0,4712,45864,37518,8346
7/3/2016 22:00,54958,6534,0,4712,43712,33888,9824
7/3/2016 23:00,52201,7000,0,4712,40489,30366,10123
7/4/2016 0:00,48720,7964,0,4712,36044,28307,7737
7/4/2016 1:00,45429,7047,0,4712,33670,27873,5797
7/4/2016 2:00,43029,6359,0,4712,31958,27111,4847
7/4/2016 3:00,41174,5960,0,4712,30502,26858,3644
7/4/2016 4:00,39821,5364,0,4712,29745,27266,2479
7/4/2016 5:00,39029,4753,0,4712,29564,27375,2189
7/4/2016 6:00,38836,4587,7,4712,29531,27314,2217
7/4/2016 7:00,38428,4902,108,4712,28705,28588,117
7/4/2016 8:00,38469,5369,161,4712,28228,30452,-2224
7/4/2016 9:00,40411,5958,331,4712,29410,33797,-4387
7/4/2016 10:00,43343,4802,423,4712,33406,37743,-4337
7/4/2016 11:00,46630,4204,450,4712,37263,40949,-3686
7/4/2016 12:00,49933,3703,447,4712,41070,43711,-2641
7/4/2016 13:00,52840,3372,460,4712,44296,45035,-739
7/4/2016 14:00,55668,3318,448,4712,47190,46496,694
7/4/2016 15:00,57849,3577,447,4712,49113,47576,1537
7/4/2016 16:00,59492,3636,453,4712,50691,47694,2997
7/4/2016 17:00,60503,4291,371,4712,51130,46585,4545
7/4/2016 18:00,60705,4954,318,4712,50721,43702,7019
7/4/2016 19:00,59594,5790,181,4712,48911,40689,8222
7/4/2016 20:00,57421,6991,0,4712,45717,37943,7774
7/4/2016 21:00,55050,7732,0,4712,42605,34653,7952
7/4/2016 22:00,53060,8881,0,4712,39467,31551,7916
7/4/2016 23:00,50631,9482,0,4712,36437,28036,8401
7/5/2016 0:00,47818,10142,0,4712,32964,25172,7792
7/5/2016 1:00,44407,10142,0,4712,29552,23071,6481
7/5/2016 2:00,41489,10838,0,4712,25939,22899,3040
7/5/2016 3:00,39913,9461,0,4712,25740,23458,2282
7/5/2016 4:00,39103,9170,0,4712,25221,25304,-83
7/5/2016 5:00,38959,8132,0,4712,26115,27073,-958
7/5/2016 6:00,40039,8366,1,4712,26960,28021,-1061
7/5/2016 7:00,41553,8181,115,4712,28544,29868,-1324
7/5/2016 8:00,42839,8902,227,4712,28998,32598,-3600
7/5/2016 9:00,45366,8113,379,4712,32162,36840,-4678
7/5/2016 10:00,48478,7217,458,4712,36091,39279,-3188
7/5/2016 11:00,52029,8607,495,4712,38215,41078,-2863
7/5/2016 12:00,55239,8453,498,4712,41576,43577,-2001
7/5/2016 13:00,57961,8829,485,4712,43936,44781,-845
7/5/2016 14:00,60514,10121,487,4712,45194,45049,145
7/5/2016 15:00,62626,9948,381,4712,47585,44903,2682
7/5/2016 16:00,63727,11057,419,4712,47539,44253,3286
7/5/2016 17:00,64003,11645,411,4712,47235,43887,3348
7/5/2016 18:00,64078,10460,323,4712,48583,42367,6216
7/5/2016 19:00,62954,11996,167,4712,46079,39767,6312
7/5/2016 20:00,60999,12116,0,4712,44170,38085,6085
7/5/2016 21:00,58848,11285,0,4712,42851,34129,8722
7/5/2016 22:00,57379,12088,0,4712,40580,30398,10182
7/5/2016 23:00,53714,12292,0,4712,36710,26804,9906
7/6/2016 0:00,49543,13033,0,4712,31799,24234,7565
7/6/2016 1:00,46137,13130,0,4712,28295,22323,5972
7/6/2016 2:00,43920,13032,0,4712,26177,21571,4606
7/6/2016 3:00,42193,12795,0,4712,24686,21714,2972
7/6/2016 4:00,41169,12707,0,4712,23751,23145,606
7/6/2016 5:00,40845,11902,0,4712,24231,25187,-956
7/6/2016 6:00,41708,12045,0,4712,24951,26290,-1339
7/6/2016 7:00,43091,11324,161,4712,26894,28623,-1729
7/6/2016 8:00,44083,12306,218,4712,26848,30725,-3877
7/6/2016 9:00,46730,12158,340,4712,29520,34776,-5256
7/6/2016 10:00,50147,11561,398,4712,33476,38672,-5196
7/6/2016 11:00,53972,10244,497,4712,38519,43062,-4543
7/6/2016 12:00,57397,8866,489,4712,43331,46392,-3061
7/6/2016 13:00,60371,8224,481,4712,46955,48186,-1231
7/6/2016 14:00,62863,8446,484,4712,49221,48339,882
7/6/2016 15:00,64854,9176,459,4712,50507,47857,2650
7/6/2016 16:00,65703,10726,455,4712,49809,46952,2857
7/6/2016 17:00,66059,11707,422,4712,49218,45253,3965
7/6/2016 18:00,65829,11440,323,4712,49354,43815,5539
7/6/2016 19:00,64697,10964,168,4712,48852,40966,7886
7/6/2016 20:00,62393,11869,0,4712,45812,38531,7281
7/6/2016 21:00,59723,11415,0,4712,43596,35631,7965
7/6/2016 22:00,57934,10838,0,4712,42384,32361,10023
7/6/2016 23:00,54121,10895,0,4712,38514,28660,9854
7/7/2016 0:00,49817,11519,0,4712,33586,25905,7681
7/7/2016 1:00,46197,12416,0,4712,29069,23418,5651
7/7/2016 2:00,43613,12743,0,4712,26159,22394,3765
7/7/2016 3:00,41811,12391,0,4712,24708,22139,2569
7/7/2016 4:00,40719,12589,0,4712,23417,22991,426
7/7/2016 5:00,40532,12489,0,4712,23330,24538,-1208
7/7/2016 6:00,41532,11728,0,4712,25092,26175,-1083
7/7/2016 7:00,42953,11196,157,4712,26888,28122,-1234
7/7/2016 8:00,44065,11664,296,4712,27393,31249,-3856
7/7/2016 9:00,46605,10908,374,4712,30610,35556,-4946
7/7/2016 10:00,49911,9954,413,4712,34832,39403,-4571
7/7/2016 11:00,53576,8848,442,4712,39574,43126,-3552
7/7/2016 12:00,57125,7742,457,4712,44213,46595,-2382
7/7/2016 13:00,60037,6940,458,4712,47928,49133,-1205
7/7/2016 14:00,62688,6608,469,4712,50898,50264,634
7/7/2016 15:00,64920,6588,471,4712,53149,50435,2714
7/7/2016 16:00,65856,7447,438,4712,53259,49428,3831
7/7/2016 17:00,66156,8350,370,4712,52724,47385,5339
7/7/2016 18:00,65851,9558,303,4712,51278,44383,6895
7/7/2016 19:00,64387,10352,173,4712,49150,40913,8237
7/7/2016 20:00,62258,11548,0,4712,45998,38105,7893
7/7/2016 21:00,59821,12026,0,4712,43083,34992,8091
7/7/2016 22:00,58061,11398,0,4712,41951,30985,10966
7/7/2016 23:00,54228,12186,0,4712,37329,27855,9474
7/8/2016 0:00,50069,11715,0,4712,33642,25621,8021
7/8/2016 1:00,46546,11472,0,4712,30362,24496,5866
7/8/2016 2:00,43918,10633,0,4712,28573,24067,4506
7/8/2016 3:00,41941,10252,0,4712,26977,24526,2451
7/8/2016 4:00,40589,8979,0,4712,26898,25884,1014
7/8/2016 5:00,40094,8574,0,4712,26807,26949,-142
7/8/2016 6:00,40792,8573,2,4712,27505,28618,-1113
7/8/2016 7:00,41989,7221,114,4712,29942,30829,-887
7/8/2016 8:00,43104,7912,279,4712,30200,33428,-3228
7/8/2016 9:00,45846,7779,424,4712,32931,37901,-4970
7/8/2016 10:00,49303,6607,459,4712,37524,42560,-5036
7/8/2016 11:00,53182,5965,481,4712,42024,45571,-3547
7/8/2016 12:00,56621,5773,497,4712,45639,48487,-2848
7/8/2016 13:00,59658,5286,487,4712,49173,50718,-1545
7/8/2016 14:00,62513,4751,463,4712,52586,51430,1156
7/8/2016 15:00,64637,5709,401,4712,53815,50672,3143
7/8/2016 16:00,65761,7143,367,4712,53539,49644,3895
7/8/2016 17:00,66020,8001,313,4712,52993,47927,5066
7/8/2016 18:00,65460,7518,206,4712,53024,46081,6943
7/8/2016 19:00,63784,6648,112,4712,52312,43998,8314
7/8/2016 20:00,61138,6723,0,4712,49704,41824,7880
7/8/2016 21:00,58305,6531,0,4712,47062,38727,8335
7/8/2016 22:00,56374,7029,0,4712,44633,34644,9989
7/8/2016 23:00,53000,7065,0,4712,41223,31366,9857
7/9/2016 0:00,49095,6553,0,4712,37830,29257,8573
7/9/2016 1:00,45496,6499,0,4712,34285,28218,6067
7/9/2016 2:00,42878,6015,0,4712,32151,27107,5044
7/9/2016 3:00,41003,5550,0,4712,30741,26359,4382
7/9/2016 4:00,39689,5494,0,4712,29482,26511,2971
7/9/2016 5:00,38877,5350,0,4712,28816,26615,2201
7/9/2016 6:00,38712,5450,0,4712,28550,27083,1467
7/9/2016 7:00,38705,5757,133,4712,28103,29847,-1744
7/9/2016 8:00,39459,5280,253,4712,29213,33325,-4112
7/9/2016 9:00,42551,5221,365,4712,32253,37273,-5020
7/9/2016 10:00,46456,4824,425,4712,36495,41343,-4848
7/9/2016 11:00,50535,4004,485,4712,41334,44742,-3408
7/9/2016 12:00,54099,3602,511,4712,45274,46741,-1467
7/9/2016 13:00,57114,3772,504,4712,48126,47566,560
7/9/2016 14:00,59399,4521,502,4712,49663,48015,1648
7/9/2016 15:00,61081,4906,470,4712,50993,47127,3866
7/9/2016 16:00,62068,5250,474,4712,51631,43975,7656
7/9/2016 17:00,61091,6322,400,4712,49657,41669,7988
7/9/2016 18:00,58910,6803,306,4712,47090,38974,8116
7/9/2016 19:00,56903,7510,139,4712,44542,37105,7437
7/9/2016 20:00,54475,7771,0,4712,41991,35190,6801
7/9/2016 21:00,52662,7984,0,4712,39966,32356,7610
7/9/2016 22:00,51341,8810,0,4712,37819,28502,9317
7/9/2016 23:00,48439,9614,0,4712,34112,25307,8805
7/10/2016 0:00,45306,9165,0,4712,31430,23585,7845
7/10/2016 1:00,42363,9652,0,4712,27999,21601,6398
7/10/2016 2:00,39978,9835,0,4712,25431,20712,4719
7/10/2016 3:00,38203,9399,0,4712,24093,20412,3681
7/10/2016 4:00,37019,9216,0,4712,23091,20808,2283
7/10/2016 5:00,36350,9177,0,4712,22461,20608,1853
7/10/2016 6:00,36275,9375,0,4712,22188,21529,659
7/10/2016 7:00,36353,8702,39,4712,22901,24320,-1419
7/10/2016 8:00,36887,8648,104,4712,23423,26564,-3141
7/10/2016 9:00,39447,8892,228,4712,25614,30534,-4920
7/10/2016 10:00,42879,7250,358,4712,30559,34808,-4249
7/10/2016 11:00,46203,6462,437,4712,34591,37997,-3406
7/10/2016 12:00,49580,6435,478,4712,37955,40732,-2777
7/10/2016 13:00,53024,7314,489,4712,40509,42187,-1678
7/10/2016 14:00,56003,8394,439,4712,42458,43018,-560
7/10/2016 15:00,58327,9171,412,4712,44032,43634,398
7/10/2016 16:00,60004,9514,368,4712,45411,43782,1629
7/10/2016 17:00,61063,9595,319,4712,46437,43003,3434
7/10/2016 18:00,61393,9615,281,4712,46785,40555,6230
7/10/2016 19:00,60458,9759,171,4712,45816,38369,7447
7/10/2016 20:00,58326,9950,0,4712,43663,36267,7396
7/10/2016 21:00,56379,11104,0,4712,40563,32259,8304
7/10/2016 22:00,55180,12295,0,4712,38173,27719,10454
7/10/2016 23:00,51965,13300,0,4712,33953,24240,9713
7/11/2016 0:00,48096,13662,0,4712,29722,22124,7598
7/11/2016 1:00,44810,13423,0,4712,26675,20888,5787
7/11/2016 2:00,42483,13395,0,4712,24376,20049,4327
7/11/2016 3:00,40854,13308,0,4712,22834,20265,2569
7/11/2016 4:00,40116,13224,0,4712,22180,21413,767
7/11/2016 5:00,40106,13053,0,4712,22341,23126,-785
7/11/2016 6:00,41265,13018,1,4712,23535,24500,-965
7/11/2016 7:00,42726,12540,84,4712,25390,26483,-1093
7/11/2016 8:00,43671,13256,179,4712,25525,29183,-3658
7/11/2016 9:00,46038,12813,299,4712,28214,33025,-4811
7/11/2016 10:00,49156,12115,416,4712,31913,36689,-4776
7/11/2016 11:00,52679,11470,500,4712,35997,40077,-4080
7/11/2016 12:00,56150,11263,509,4712,39666,42598,-2932
7/11/2016 13:00,59231,11012,511,4712,42996,44693,-1697
7/11/2016 14:00,61991,11092,512,4712,45675,45797,-122
7/11/2016 15:00,63994,11144,438,4712,47700,46079,1621
7/11/2016 16:00,65361,11373,433,4712,48843,45419,3424
7/11/2016 17:00,65845,11891,373,4712,48869,43284,5585
7/11/2016 18:00,65355,12204,345,4712,48094,40835,7259
7/11/2016 19:00,63730,12269,232,4712,46517,38366,8151
7/11/2016 20:00,61139,12638,0,4712,43788,36262,7526
7/11/2016 21:00,58618,13129,0,4712,40778,32115,8663
7/11/2016 22:00,56916,13461,0,4712,38743,28066,10677
7/11/2016 23:00,53052,13717,0,4712,34624,24877,9747
7/12/2016 0:00,48879,13525,0,4712,30642,22368,8274
7/12/2016 1:00,45359,13239,0,4712,27408,21080,6328
7/12/2016 2:00,42814,12904,0,4712,25198,20683,4515
7/12/2016 3:00,40973,12512,0,4712,23749,20582,3167
7/12/2016 4:00,39861,12362,0,4712,22787,21990,797
7/12/2016 5:00,39531,11865,0,4712,22955,23374,-419
7/12/2016 6:00,40481,11848,0,4712,23921,24917,-996
7/12/2016 7:00,41976,10795,160,4712,26309,27671,-1362
7/12/2016 8:00,43120,10154,283,4712,27970,29958,-1988
7/12/2016 9:00,45677,11314,362,4712,29289,33001,-3712
7/12/2016 10:00,48841,10760,474,4712,32895,37147,-4252
7/12/2016 11:00,52358,9426,503,4712,37717,41091,-3374
7/12/2016 12:00,55833,8582,520,4712,42020,44454,-2434
7/12/2016 13:00,58831,8250,518,4712,45352,46474,-1122
7/12/2016 14:00,61550,8717,522,4712,47599,47677,-78
7/12/2016 15:00,63679,9380,517,4712,49070,47832,1238
7/12/2016 16:00,65292,9773,494,4712,50313,47396,2917
7/12/2016 17:00,66020,10168,442,4712,50698,45237,5461
7/12/2016 18:00,65672,10916,355,4712,49688,42553,7135
7/12/2016 19:00,64145,11077,208,4712,48148,40181,7967
7/12/2016 20:00,61727,11665,0,4712,45349,37936,7413
7/12/2016 21:00,59396,12306,0,4712,42378,33718,8660
7/12/2016 22:00,57797,12875,0,4712,40210,29421,10789
7/12/2016 23:00,53946,13221,0,4712,36013,26392,9621
7/13/2016 0:00,49699,12947,0,4712,32040,24293,7747
7/13/2016 1:00,46127,12592,0,4712,28823,23336,5487
7/13/2016 2:00,43712,12297,0,4712,26704,22436,4268
7/13/2016 3:00,42046,12221,0,4712,25113,22508,2605
7/13/2016 4:00,40910,11770,0,4712,24428,23967,461
7/13/2016 5:00,40631,11353,0,4712,24566,25333,-767
7/13/2016 6:00,41645,11412,0,4712,25520,26409,-889
7/13/2016 7:00,43198,11196,161,4712,27129,28392,-1263
7/13/2016 8:00,44418,12010,295,4712,27401,31278,-3877
7/13/2016 9:00,47199,12110,439,4712,29939,35236,-5297
7/13/2016 10:00,50801,11450,487,4712,34152,38889,-4737
7/13/2016 11:00,54715,10475,516,4712,39013,42552,-3539
7/13/2016 12:00,58245,9799,526,4712,43208,45672,-2464
7/13/2016 13:00,61200,9235,525,4712,46729,47737,-1008
7/13/2016 14:00,63881,9127,526,4712,49516,48854,662
7/13/2016 15:00,65950,9146,518,4712,51574,49364,2210
7/13/2016 16:00,66913,9049,492,4712,52660,49070,3590
7/13/2016 17:00,67369,9731,440,4712,52485,47439,5046
7/13/2016 18:00,67187,10722,347,4712,51405,44612,6793
7/13/2016 19:00,66125,11087,187,4712,50138,42066,8072
7/13/2016 20:00,63861,10697,0,4712,48452,39748,8704
7/13/2016 21:00,61154,11929,0,4712,44514,35378,9136
7/13/2016 22:00,59214,12594,0,4712,41907,30896,11011
7/13/2016 23:00,55295,13088,0,4712,37495,27419,10076
7/14/2016 0:00,51053,13047,0,4712,33294,24950,8344
7/14/2016 1:00,47406,12529,0,4712,30165,23727,6438
7/14/2016 2:00,44689,12305,0,4712,27672,22870,4802
7/14/2016 3:00,42684,11964,0,4712,26008,23133,2875
7/14/2016 4:00,41392,11337,0,4712,25343,24420,923
7/14/2016 5:00,40887,10900,0,4712,25275,26011,-736
7/14/2016 6:00,41751,10470,0,4712,26569,27466,-897
7/14/2016 7:00,43055,8720,160,4712,29463,30280,-817
7/14/2016 8:00,44052,9553,294,4712,29494,32338,-2844
7/14/2016 9:00,46571,9769,407,4712,31682,36476,-4794
7/14/2016 10:00,50047,8881,499,4712,35954,41046,-5092
7/14/2016 11:00,53958,8019,508,4712,40719,44776,-4057
7/14/2016 12:00,57736,6904,523,4712,45597,48182,-2585
7/14/2016 13:00,60861,6044,528,4712,49577,50677,-1100
7/14/2016 14:00,63767,5634,529,4712,52892,51388,1504
7/14/2016 15:00,66024,5880,521,4712,54911,51237,3674
7/14/2016 16:00,67131,7748,494,4712,54177,49800,4377
7/14/2016 17:00,67445,8683,440,4712,53610,48195,5415
7/14/2016 18:00,67128,8923,350,4712,53143,45815,7328
7/14/2016 19:00,65857,8988,190,4712,51966,43158,8808
7/14/2016 20:00,63406,9081,0,4712,49613,41033,8580
7/14/2016 21:00,60761,8538,0,4712,47511,37811,9700
7/14/2016 22:00,58840,8340,0,4712,45788,34786,11002
7/14/2016 23:00,54713,6631,0,4712,43370,32992,10378
7/15/2016 0:00,50261,5722,0,4712,39827,31535,8292
7/15/2016 1:00,46436,4642,0,4712,37082,30185,6897
7/15/2016 2:00,43792,4591,0,4712,34489,28792,5697
7/15/2016 3:00,41845,4707,0,4712,32427,28503,3924
7/15/2016 4:00,40652,4563,0,4712,31377,29188,2189
7/15/2016 5:00,40256,4557,0,4712,30987,30777,210
7/15/2016 6:00,41024,4144,0,4712,32167,32289,-122
7/15/2016 7:00,42232,2994,159,4712,34367,34129,238
7/15/2016 8:00,43040,3541,292,4712,34495,36453,-1958
7/15/2016 9:00,45287,3217,390,4712,36968,38689,-1721
7/15/2016 10:00,47723,2937,442,4712,39631,41494,-1863
7/15/2016 11:00,50208,2683,508,4712,42305,44276,-1971
7/15/2016 12:00,52886,2755,524,4712,44895,47372,-2477
7/15/2016 13:00,55864,2767,524,4712,47860,49960,-2100
7/15/2016 14:00,59027,2767,518,4712,51030,51093,-63
7/15/2016 15:00,61710,3593,493,4712,52912,51304,1608
7/15/2016 16:00,63773,5040,504,4712,53517,50350,3167
7/15/2016 17:00,64982,6203,400,4712,53668,47751,5917
7/15/2016 18:00,64923,7158,315,4712,52738,44814,7924
7/15/2016 19:00,63257,7233,216,4712,51096,42779,8317
7/15/2016 20:00,60596,6738,0,4712,49146,40755,8391
7/15/2016 21:00,58111,7259,0,4712,46140,37392,8748
7/15/2016 22:00,56168,6917,0,4712,44539,32954,11585
7/15/2016 23:00,52608,8118,0,4712,39778,29220,10558
7/16/2016 0:00,48749,8455,0,4712,35582,26712,8870
7/16/2016 1:00,45192,8521,0,4712,31959,24255,7704
7/16/2016 2:00,42387,10348,0,4712,27326,22568,4758
7/16/2016 3:00,40378,9297,0,4712,26369,23318,3051
7/16/2016 4:00,38954,6833,0,4712,27409,24899,2510
7/16/2016 5:00,37930,4862,0,4712,28356,25798,2558
7/16/2016 6:00,37483,4102,0,4712,28670,27016,1654
7/16/2016 7:00,37417,2849,161,4712,29695,30039,-344
7/16/2016 8:00,37773,2733,287,4712,30041,33063,-3022
7/16/2016 9:00,40442,3565,353,4712,31812,35967,-4155
7/16/2016 10:00,44110,4110,404,4712,34884,39375,-4491
7/16/2016 11:00,48282,4329,515,4712,38726,42210,-3484
7/16/2016 12:00,52317,4360,525,4712,42720,44610,-1890
7/16/2016 13:00,55819,4681,524,4712,45903,46213,-310
7/16/2016 14:00,58619,5539,526,4712,47842,46922,920
7/16/2016 15:00,60865,6408,519,4712,49227,47131,2096
7/16/2016 16:00,62448,7046,494,4712,50195,46267,3928
7/16/2016 17:00,63407,7828,443,4712,50424,44435,5989
7/16/2016 18:00,63185,8086,348,4712,50039,42104,7935
7/16/2016 19:00,61730,7975,194,4712,48848,40055,8793
7/16/2016 20:00,59295,8294,0,4712,46289,37173,9116
7/16/2016 21:00,56749,10386,0,4712,41650,32790,8860
7/16/2016 22:00,55095,11632,0,4712,38751,28997,9754
7/16/2016 23:00,51824,11750,0,4712,35362,25520,9842
7/17/2016 0:00,48160,11804,0,4712,31644,23416,8228
7/17/2016 1:00,44800,11460,0,4712,28627,22287,6340
7/17/2016 2:00,42113,11033,0,4712,26369,21350,5019
7/17/2016 3:00,40042,10468,0,4712,24862,20918,3944
7/17/2016 4:00,38575,10082,0,4712,23781,20746,3035
7/17/2016 5:00,37551,9871,0,4712,22969,20856,2113
7/17/2016 6:00,37113,9095,0,4712,23306,21936,1370
7/17/2016 7:00,36682,8152,181,4712,23637,25608,-1971
7/17/2016 8:00,37202,8611,304,4712,23575,27828,-4253
7/17/2016 9:00,40461,9636,353,4712,25760,31104,-5344
7/17/2016 10:00,44398,9335,477,4712,29875,34453,-4578
7/17/2016 11:00,48171,8912,515,4712,34032,37582,-3550
7/17/2016 12:00,51688,8733,525,4712,37718,39936,-2218
7/17/2016 13:00,55013,8767,523,4712,41011,41652,-641
7/17/2016 14:00,57812,8816,523,4712,43761,42561,1200
7/17/2016 15:00,59861,8657,515,4712,45977,42806,3171
7/17/2016 16:00,60837,8369,490,4712,47266,43388,3878
7/17/2016 17:00,60936,7079,437,4712,48708,42789,5919
7/17/2016 18:00,60759,9097,306,4712,46643,40800,5843
7/17/2016 19:00,60052,9234,195,4712,45911,39156,6755
7/17/2016 20:00,58367,9173,0,4712,44482,37255,7227
7/17/2016 21:00,56343,10160,0,4712,41471,33193,8278
7/17/2016 22:00,55015,11110,0,4712,39193,29118,10075
7/17/2016 23:00,51725,10981,0,4712,36032,27109,8923
7/18/2016 0:00,47705,10435,0,4712,32558,25240,7318
7/18/2016 1:00,44270,10242,0,4712,29316,24215,5101
7/18/2016 2:00,41852,9482,0,4712,27657,23507,4150
7/18/2016 3:00,40055,9284,0,4712,26059,23505,2554
7/18/2016 4:00,38979,9134,0,4712,25133,24906,227
7/18/2016 5:00,38810,8594,0,4712,25504,26617,-1113
7/18/2016 6:00,39773,8228,0,4712,26833,28422,-1589
7/18/2016 7:00,41173,6689,137,4712,29635,31992,-2357
7/18/2016 8:00,42370,6973,244,4712,30442,34898,-4456
7/18/2016 9:00,45373,6320,299,4712,34042,39558,-5516
7/18/2016 10:00,49111,4733,480,4712,39186,44828,-5642
7/18/2016 11:00,53026,3356,507,4712,44451,48141,-3690
7/18/2016 12:00,56865,3198,520,4712,48435,50058,-1623
7/18/2016 13:00,59894,3818,514,4712,50850,50389,461
7/18/2016 14:00,62463,4496,515,4712,52740,50462,2278
7/18/2016 15:00,63585,4964,505,4712,53404,50730,2674
7/18/2016 16:00,64238,4958,463,4712,54104,50625,3479
7/18/2016 17:00,64619,5222,428,4712,54258,49082,5176
7/18/2016 18:00,64124,5841,332,4712,53239,46424,6815
7/18/2016 19:00,62963,6404,180,4712,51667,44338,7329
7/18/2016 20:00,60802,6537,0,4712,49554,41941,7613
7/18/2016 21:00,58696,7431,0,4712,46553,37350,9203
7/18/2016 22:00,56934,8260,0,4712,43962,32860,11102
7/18/2016 23:00,53108,8316,0,4712,40080,30435,9645
7/19/2016 0:00,48740,8075,0,4712,35953,28628,7325
7/19/2016 1:00,45138,7749,0,4712,32677,27060,5617
7/19/2016 2:00,42586,7637,0,4712,30237,26172,4065
7/19/2016 3:00,40697,7228,0,4712,28757,26352,2405
7/19/2016 4:00,39547,6512,0,4712,28323,27688,635
7/19/2016 5:00,39231,5826,0,4712,28692,29676,-984
7/19/2016 6:00,40121,5084,0,4712,30325,31524,-1199
7/19/2016 7:00,41559,3843,122,4712,32882,34812,-1930
7/19/2016 8:00,42724,3519,227,4712,34266,37952,-3686
7/19/2016 9:00,45757,3750,352,4712,36943,41906,-4963
7/19/2016 10:00,49513,2927,458,4712,41415,45584,-4169
7/19/2016 11:00,53397,1916,501,4712,46268,48319,-2051
7/19/2016 12:00,56551,1762,514,4712,49562,49898,-336
7/19/2016 13:00,58508,2326,509,4712,50961,51093,-132
7/19/2016 14:00,60469,3136,514,4712,52107,51762,345
7/19/2016 15:00,62468,4045,508,4712,53203,51597,1606
7/19/2016 16:00,64070,4751,473,4712,54134,50421,3713
7/19/2016 17:00,64863,5826,375,4712,53950,48398,5552
7/19/2016 18:00,64304,6183,191,4712,53218,45907,7311
7/19/2016 19:00,62599,6444,114,4712,51329,44326,7003
7/19/2016 20:00,60332,6087,0,4712,49533,42379,7154
7/19/2016 21:00,58189,7105,0,4712,46372,37230,9142
7/19/2016 22:00,56503,8253,0,4712,43538,32834,10704
7/19/2016 23:00,52784,8588,0,4712,39485,29708,9777
7/20/2016 0:00,48663,8418,0,4712,35533,27608,7925
7/20/2016 1:00,45148,8762,0,4712,31674,25883,5791
7/20/2016 2:00,42702,8606,0,4712,29384,25183,4201
7/20/2016 3:00,40870,8235,0,4712,27923,25300,2623
7/20/2016 4:00,39681,7747,0,4712,27222,26681,541
7/20/2016 5:00,39301,6963,0,4712,27627,28489,-862
7/20/2016 6:00,40222,6252,0,4712,29258,30253,-995
7/20/2016 7:00,41656,4564,183,4712,32197,33905,-1708
7/20/2016 8:00,42746,4940,282,4712,32811,37306,-4495
7/20/2016 9:00,45678,3831,361,4712,36773,42159,-5386
7/20/2016 10:00,49497,2906,495,4712,41385,46072,-4687
7/20/2016 11:00,53499,2718,502,4712,45567,48688,-3121
7/20/2016 12:00,56944,3049,506,4712,48676,50897,-2221
7/20/2016 13:00,60017,3683,508,4712,51114,52150,-1036
7/20/2016 14:00,62916,4678,507,4712,53020,52633,387
7/20/2016 15:00,64936,5456,481,4712,54287,53024,1263
7/20/2016 16:00,66319,5781,443,4712,55384,52598,2786
7/20/2016 17:00,67072,5810,405,4712,56145,50857,5288
7/20/2016 18:00,66687,6352,292,4712,55331,48191,7140
7/20/2016 19:00,65219,6712,142,4712,53653,45610,8043
7/20/2016 20:00,62765,6801,0,4712,51252,43039,8213
7/20/2016 21:00,60186,7861,0,4712,47613,38327,9286
7/20/2016 22:00,58134,8332,0,4712,45090,33867,11223
7/20/2016 23:00,54141,8494,0,4712,40935,30720,10215
7/21/2016 0:00,49703,8610,0,4712,36381,28411,7970
7/21/2016 1:00,45854,8575,0,4712,32567,26770,5797
7/21/2016 2:00,42984,8349,0,4712,29923,25965,3958
7/21/2016 3:00,41004,8234,0,4712,28058,25790,2268
7/21/2016 4:00,39727,8116,0,4712,26899,26699,200
7/21/2016 5:00,39357,7657,0,4712,26988,28269,-1281
7/21/2016 6:00,40272,7285,0,4712,28275,29255,-980
7/21/2016 7:00,41654,6074,157,4712,30712,32890,-2178
7/21/2016 8:00,42775,5857,286,4712,31920,36647,-4727
7/21/2016 9:00,45823,5101,376,4712,35634,41639,-6005
7/21/2016 10:00,49713,3842,450,4712,40709,46558,-5849
7/21/2016 11:00,53910,2907,501,4712,45790,49598,-3808
7/21/2016 12:00,57806,3390,511,4712,49193,51747,-2554
7/21/2016 13:00,61258,3835,510,4712,52201,53246,-1045
7/21/2016 14:00,64116,4140,509,4712,54755,53692,1063
7/21/2016 15:00,66176,4619,453,4712,56392,53397,2995
7/21/2016 16:00,67120,5110,404,4712,56895,52936,3959
7/21/2016 17:00,67233,5065,306,4712,57149,52140,5009
7/21/2016 18:00,66928,5273,282,4712,56661,49945,6716
7/21/2016 19:00,65684,5208,122,4712,55642,47747,7895
7/21/2016 20:00,63512,5305,0,4712,53495,45033,8462
7/21/2016 21:00,61029,6670,0,4712,49647,39399,10248
7/21/2016 22:00,58818,8017,0,4712,46088,34311,11777
7/21/2016 23:00,54883,8627,0,4712,41543,30669,10874
7/22/2016 0:00,50518,8805,0,4712,37001,28048,8953
7/22/2016 1:00,46526,8993,0,4712,32821,26494,6327
7/22/2016 2:00,43552,8653,0,4712,30187,25617,4570
7/22/2016 3:00,41358,8248,0,4712,28398,25632,2766
7/22/2016 4:00,39884,7764,0,4712,27407,26518,889
7/22/2016 5:00,39407,7312,0,4712,27383,27831,-448
7/22/2016 6:00,40087,7026,0,4712,28350,29173,-823
7/22/2016 7:00,41217,5470,118,4712,30918,33808,-2890
7/22/2016 8:00,42262,3896,231,4712,33423,37691,-4268
7/22/2016 9:00,45470,3584,312,4712,36863,42745,-5882
7/22/2016 10:00,49571,2854,428,4712,41577,47414,-5837
7/22/2016 11:00,54101,2051,498,4712,46841,50277,-3436
7/22/2016 12:00,58178,2683,514,4712,50269,52417,-2148
7/22/2016 13:00,61447,3286,509,4712,52940,54168,-1228
7/22/2016 14:00,64403,3154,507,4712,56030,55068,962
7/22/2016 15:00,66418,3107,492,4712,58107,55064,3043
7/22/2016 16:00,67315,3331,495,4712,58777,55171,3606
7/22/2016 17:00,67347,3455,440,4712,58741,53920,4821
7/22/2016 18:00,67233,3685,340,4712,58496,51056,7440
7/22/2016 19:00,65959,4213,204,4712,56830,48459,8371
7/22/2016 20:00,63557,4525,0,4712,54320,45671,8649
7/22/2016 21:00,60983,6016,0,4712,50255,40861,9394
7/22/2016 22:00,58942,6910,0,4712,47320,36276,11044
7/22/2016 23:00,55225,8096,0,4712,42417,32257,10160
7/23/2016 0:00,51372,8521,0,4712,38139,29622,8517
7/23/2016 1:00,47738,8591,0,4712,34435,27674,6761
7/23/2016 2:00,44809,8296,0,4712,31801,26818,4983
7/23/2016 3:00,42506,7525,0,4712,30269,26576,3693
7/23/2016 4:00,40996,6872,0,4712,29412,26731,2681
7/23/2016 5:00,39833,6569,0,4712,28552,27075,1477
7/23/2016 6:00,39579,6136,0,4712,28731,27652,1079
7/23/2016 7:00,39636,5434,154,4712,29336,31913,-2577
7/23/2016 8:00,40229,4457,234,4712,30827,35753,-4926
7/23/2016 9:00,43703,4452,359,4712,34181,40374,-6193
7/23/2016 10:00,48193,4076,484,4712,38922,44947,-6025
7/23/2016 11:00,52787,3427,502,4712,44147,47492,-3345
7/23/2016 12:00,56953,4214,517,4712,47510,49712,-2202
7/23/2016 13:00,60296,4244,515,4712,50825,51321,-496
7/23/2016 14:00,62832,4533,513,4712,53074,52312,762
7/23/2016 15:00,64716,4388,499,4712,55117,52951,2166
7/23/2016 16:00,65940,4487,469,4712,56271,52539,3732
7/23/2016 17:00,66559,4635,413,4712,56799,51429,5370
7/23/2016 18:00,66337,4688,372,4712,56566,49330,7236
7/23/2016 19:00,65020,4931,229,4712,55148,47223,7925
7/23/2016 20:00,62800,5260,0,4712,52828,44406,8422
7/23/2016 21:00,60463,6638,0,4712,49113,39822,9291
7/23/2016 22:00,58615,8450,0,4712,45454,35030,10424
7/23/2016 23:00,55192,9890,0,4712,40589,30891,9698
7/24/2016 0:00,51546,10026,0,4712,36808,28390,8418
7/24/2016 1:00,48029,9841,0,4712,33476,26959,6517
7/24/2016 2:00,45282,9146,0,4712,31424,25960,5464
7/24/2016 3:00,43042,8546,0,4712,29784,25578,4206
7/24/2016 4:00,41332,7338,0,4712,29282,26044,3238
7/24/2016 5:00,40119,6351,0,4712,29056,26511,2545
7/24/2016 6:00,39541,5711,0,4712,29117,27619,1498
7/24/2016 7:00,39113,4691,126,4712,29584,31457,-1873
7/24/2016 8:00,39372,3999,305,4712,30356,34900,-4544
7/24/2016 9:00,42692,4053,366,4712,33561,39535,-5974
7/24/2016 10:00,47073,3236,423,4712,38701,44413,-5712
7/24/2016 11:00,51382,2388,508,4712,43774,48285,-4511
7/24/2016 12:00,55567,2023,521,4712,48311,51280,-2969
7/24/2016 13:00,59227,2293,517,4712,51705,52883,-1178
7/24/2016 14:00,62176,2480,517,4712,54468,54022,446
7/24/2016 15:00,64273,2867,507,4712,56187,54188,1999
7/24/2016 16:00,65608,3410,417,4712,57069,53734,3335
7/24/2016 17:00,66292,3854,425,4712,57301,52252,5049
7/24/2016 18:00,66260,4617,330,4712,56601,49622,6979
7/24/2016 19:00,65077,5519,170,4712,54676,47025,7651
7/24/2016 20:00,63165,6111,0,4712,52342,44806,7536
7/24/2016 21:00,61075,6699,0,4712,49665,40977,8688
7/24/2016 22:00,59507,7129,0,4712,47667,36394,11273
7/24/2016 23:00,55843,7431,0,4712,43699,32900,10799
7/25/2016 0:00,51449,7039,0,4712,39698,30893,8805
7/25/2016 1:00,47574,6173,0,4712,36690,29615,7075
7/25/2016 2:00,44771,5358,0,4712,34701,29092,5609
7/25/2016 3:00,42749,4815,0,4712,33223,29135,4088
7/25/2016 4:00,41519,4475,0,4712,32333,30260,2073
7/25/2016 5:00,41076,3586,0,4712,32778,32344,434
7/25/2016 6:00,41859,2817,0,4712,34329,33666,663
7/25/2016 7:00,43333,2106,152,4712,36363,37060,-697
7/25/2016 8:00,44279,1855,302,4712,37410,40357,-2947
7/25/2016 9:00,46569,1200,383,4712,40275,44508,-4233
7/25/2016 10:00,49909,576,462,4712,44159,48114,-3955
7/25/2016 11:00,53782,373,514,4712,48183,51588,-3405
7/25/2016 12:00,57474,458,498,4712,51806,54221,-2415
7/25/2016 13:00,61172,856,512,4712,55092,55186,-94
7/25/2016 14:00,64217,1505,503,4712,57498,54300,3198
7/25/2016 15:00,65784,2264,501,4712,58307,52068,6239
7/25/2016 16:00,65513,3523,471,4712,56807,49350,7457
7/25/2016 17:00,63945,3662,414,4712,55157,47251,7906
7/25/2016 18:00,61940,3396,315,4712,53517,44698,8819
7/25/2016 19:00,59312,4334,219,4712,50046,42706,7340
7/25/2016 20:00,56791,4468,0,4712,47611,40608,7003
7/25/2016 21:00,55212,4591,0,4712,45909,36686,9223
7/25/2016 22:00,53224,5324,0,4712,43188,32686,10502
7/25/2016 23:00,49658,5521,0,4712,39426,29860,9566
7/26/2016 0:00,45584,4676,0,4712,36196,28102,8094
7/26/2016 1:00,42325,3778,0,4712,33835,27699,6136
7/26/2016 2:00,39911,2569,0,4712,32630,27980,4650
7/26/2016 3:00,38372,1505,0,4712,32154,28440,3714
7/26/2016 4:00,37509,1343,0,4712,31454,29604,1850
7/26/2016 5:00,37537,1243,0,4712,31582,31383,199
7/26/2016 6:00,38649,1277,0,4712,32660,32595,65
7/26/2016 7:00,40338,1087,163,4712,34376,34636,-260
7/26/2016 8:00,41331,956,293,4712,35370,37457,-2087
7/26/2016 9:00,43493,1199,355,4712,37227,40899,-3672
7/26/2016 10:00,46550,1014,436,4712,40388,44862,-4474
7/26/2016 11:00,50202,892,510,4712,44088,47323,-3235
7/26/2016 12:00,53899,1206,519,4712,47462,49125,-1663
7/26/2016 13:00,56827,1788,510,4712,49818,48741,1077
7/26/2016 14:00,58812,2960,512,4712,50629,48237,2392
7/26/2016 15:00,59383,3408,503,4712,50760,47172,3588
7/26/2016 16:00,59575,4469,453,4712,49941,45861,4080
7/26/2016 17:00,59069,4534,400,4712,49423,44516,4907
7/26/2016 18:00,58252,4544,314,4712,48683,42185,6498
7/26/2016 19:00,56916,5444,105,4712,46655,40979,5676
7/26/2016 20:00,54778,4460,0,4712,45605,39938,5667
7/26/2016 21:00,53387,4332,0,4712,44343,36734,7609
7/26/2016 22:00,52003,4069,0,4712,43222,33199,10023
7/26/2016 23:00,48692,3714,0,4712,40266,30847,9419
7/27/2016 0:00,44792,3696,0,4712,36384,28682,7702
7/27/2016 1:00,41628,3647,0,4712,33269,27316,5953
7/27/2016 2:00,39450,3435,0,4712,31303,26833,4470
7/27/2016 3:00,37924,3142,0,4712,30071,27358,2713
7/27/2016 4:00,37130,2338,0,4712,30080,29546,534
7/27/2016 5:00,37220,1774,0,4712,30734,31850,-1116
7/27/2016 6:00,38601,1490,0,4712,32398,32559,-161
7/27/2016 7:00,40686,1264,114,4712,34596,34538,58
7/27/2016 8:00,41720,1385,238,4712,35385,37051,-1666
7/27/2016 9:00,43760,1469,377,4712,37202,40074,-2872
7/27/2016 10:00,46472,1214,495,4712,40051,42941,-2890
7/27/2016 11:00,49378,1325,506,4712,42835,44751,-1916
7/27/2016 12:00,52170,1983,516,4712,44958,46391,-1433
7/27/2016 13:00,54452,2315,513,4712,46912,46702,210
7/27/2016 14:00,56672,2972,505,4712,48482,47003,1479
7/27/2016 15:00,57600,3119,511,4712,49258,46712,2546
7/27/2016 16:00,57927,2748,485,4712,49982,45619,4363
7/27/2016 17:00,57580,2960,436,4712,49472,43962,5510
7/27/2016 18:00,56468,3386,338,4712,48033,42683,5350
7/27/2016 19:00,55273,3624,172,4712,46766,40886,5880
7/27/2016 20:00,53679,5450,0,4712,43517,38812,4705
7/27/2016 21:00,52738,5247,0,4712,42780,35174,7606
7/27/2016 22:00,51518,6080,0,4712,40726,31698,9028
7/27/2016 23:00,48270,5749,0,4712,37809,29465,8344
7/28/2016 0:00,44750,4234,0,4712,35804,28357,7447
7/28/2016 1:00,41637,3644,0,4712,33282,27025,6257
7/28/2016 2:00,39577,4241,0,4712,30624,26227,4397
7/28/2016 3:00,38174,4000,0,4712,29462,26706,2756
7/28/2016 4:00,37406,3488,0,4712,29206,28479,727
7/28/2016 5:00,37564,2581,0,4712,30270,30983,-713
7/28/2016 6:00,38973,2171,0,4712,32090,32171,-81
7/28/2016 7:00,40964,1667,130,4712,34456,34311,145
7/28/2016 8:00,41965,1666,237,4712,35350,37220,-1870
7/28/2016 9:00,44062,1705,284,4712,37361,40717,-3356
7/28/2016 10:00,47060,1686,402,4712,40260,44222,-3962
7/28/2016 11:00,50750,1357,512,4712,44169,45865,-1696
7/28/2016 12:00,54064,1600,521,4712,47231,47468,-237
7/28/2016 13:00,55688,1911,514,4712,48551,48512,39
7/28/2016 14:00,57606,2403,518,4712,49973,48909,1064
7/28/2016 15:00,59219,3034,508,4712,50966,48122,2844
7/28/2016 16:00,60217,3589,477,4712,51439,46943,4496
7/28/2016 17:00,59892,3711,399,4712,51070,44104,6966
7/28/2016 18:00,58517,4457,313,4712,49035,42416,6619
7/28/2016 19:00,56436,3472,147,4712,48105,41176,6929
7/28/2016 20:00,53972,4016,0,4712,45244,38662,6582
7/28/2016 21:00,52484,5257,0,4712,42515,34544,7971
7/28/2016 22:00,50994,5922,0,4712,40360,30617,9743
7/28/2016 23:00,47793,6356,0,4712,36725,27324,9401
7/29/2016 0:00,44172,7472,0,4712,31987,25292,6695
7/29/2016 1:00,40947,7177,0,4712,29058,24547,4511
7/29/2016 2:00,38845,6923,0,4712,27210,23546,3664
7/29/2016 3:00,37433,6819,0,4712,25902,24053,1849
7/29/2016 4:00,36524,6188,0,4712,25623,25819,-196
7/29/2016 5:00,36452,4723,0,4712,27017,28391,-1374
7/29/2016 6:00,37633,4075,0,4712,28846,29882,-1036
7/29/2016 7:00,39280,2852,172,4712,31545,32738,-1193
7/29/2016 8:00,40356,2678,273,4712,32693,35323,-2630
7/29/2016 9:00,42821,3328,358,4712,34423,38800,-4377
7/29/2016 10:00,46290,2956,488,4712,38135,42244,-4109
7/29/2016 11:00,50148,2924,511,4712,42001,44353,-2352
7/29/2016 12:00,53418,3443,520,4712,44743,46908,-2165
7/29/2016 13:00,56104,3750,510,4712,47132,48441,-1309
7/29/2016 14:00,58742,4111,516,4712,49403,49960,-557
7/29/2016 15:00,60907,3675,507,4712,52012,50424,1588
7/29/2016 16:00,62361,4533,481,4712,52636,49260,3376
7/29/2016 17:00,62930,4949,433,4712,52837,47481,5356
7/29/2016 18:00,62419,4698,316,4712,52693,45294,7399
7/29/2016 19:00,60487,4755,157,4712,50862,43408,7454
7/29/2016 20:00,57921,4654,0,4712,48555,41050,7505
7/29/2016 21:00,55682,5308,0,4712,45662,37330,8332
7/29/2016 22:00,53871,5842,0,4712,43317,33221,10096
7/29/2016 23:00,50595,5714,0,4712,40169,30591,9578
7/30/2016 0:00,47007,6231,0,4712,36065,28131,7934
7/30/2016 1:00,43841,6936,0,4712,32193,25762,6431
7/30/2016 2:00,41302,7272,0,4712,29318,24934,4384
7/30/2016 3:00,39440,6755,0,4712,27973,24950,3023
7/30/2016 4:00,38090,5559,0,4712,27818,25925,1893
7/30/2016 5:00,37335,4282,0,4712,28342,26845,1497
7/30/2016 6:00,37312,4176,0,4712,28425,28187,238
7/30/2016 7:00,37563,2889,206,4712,29756,32004,-2248
7/30/2016 8:00,38157,2410,356,4712,30679,35040,-4361
7/30/2016 9:00,41481,3154,411,4712,33204,38621,-5417
7/30/2016 10:00,45854,3002,490,4712,37651,42584,-4933
7/30/2016 11:00,50229,2695,517,4712,42305,45699,-3394
7/30/2016 12:00,54050,3051,524,4712,45762,47752,-1990
7/30/2016 13:00,57199,3490,519,4712,48478,48972,-494
7/30/2016 14:00,59747,4391,516,4712,50128,49597,531
7/30/2016 15:00,61734,4801,503,4712,51718,49363,2355
7/30/2016 16:00,62982,5369,482,4712,52419,47235,5184
7/30/2016 17:00,63097,7034,427,4712,50924,45067,5857
7/30/2016 18:00,62044,7347,321,4712,49663,42981,6682
7/30/2016 19:00,60464,7283,117,4712,48352,41082,7270
7/30/2016 20:00,58291,7322,0,4712,46257,38380,7877
7/30/2016 21:00,56211,8431,0,4712,43068,35107,7961
7/30/2016 22:00,54475,8779,0,4712,40985,32027,8958
7/30/2016 23:00,51287,8511,0,4712,38064,29010,9054
7/31/2016 0:00,47861,8858,0,4712,34291,26558,7733
7/31/2016 1:00,44654,8933,0,4712,31009,25256,5753
7/31/2016 2:00,42173,8425,0,4712,29037,24209,4828
7/31/2016 3:00,40189,8484,0,4712,26993,23686,3307
7/31/2016 4:00,38811,8275,0,4712,25824,23482,2342
7/31/2016 5:00,37995,8635,0,4712,24648,23048,1600
7/31/2016 6:00,37729,8724,0,4712,24293,23748,545
7/31/2016 7:00,37614,8000,269,4712,24633,26785,-2152
7/31/2016 8:00,37829,8516,382,4712,24219,29057,-4838
7/31/2016 9:00,40959,9520,459,4712,26268,32571,-6303
7/31/2016 10:00,45133,8597,492,4712,31331,36586,-5255
7/31/2016 11:00,49071,7660,515,4712,36184,40176,-3992
7/31/2016 12:00,52759,6846,523,4712,40679,42847,-2168
7/31/2016 13:00,55961,7050,516,4712,43683,44398,-715
7/31/2016 14:00,58530,7497,518,4712,45803,45286,517
7/31/2016 15:00,60381,7954,508,4712,47208,45304,1904
7/31/2016 16:00,61566,8641,483,4712,47730,45035,2695
7/31/2016 17:00,62124,9176,430,4712,47806,43936,3870
7/31/2016 18:00,62283,9835,321,4712,47414,41884,5530
7/31/2016 19:00,61603,9237,145,4712,47509,40635,6874
7/31/2016 20:00,59611,8915,0,4712,45985,38435,7550
7/31/2016 21:00,57543,9250,0,4712,43581,34106,9475
7/31/2016 22:00,55908,10382,0,4712,40814,29570,11244
7/31/2016 23:00,52248,11016,0,4712,36521,26994,9527
8/1/2016 0:00,48184,10720,0,4712,32752,24876,7876
8/1/2016 1:00,44657,10729,0,4712,29216,23587,5629
8/1/2016 2:00,42150,10632,0,4712,26805,22541,4264
8/1/2016 3:00,40360,10685,0,4712,24962,22213,2749
8/1/2016 4:00,39268,10443,0,4712,24113,23432,681
8/1/2016 5:00,39012,9968,0,4712,24332,25054,-722
8/1/2016 6:00,39884,9411,0,4712,25760,26318,-558
8/1/2016 7:00,41266,8626,195,4712,27732,29159,-1427
8/1/2016 8:00,42117,9315,381,4712,27709,31228,-3519
8/1/2016 9:00,44818,10174,462,4712,29470,34873,-5403
8/1/2016 10:00,48623,10118,493,4712,33300,38698,-5398
8/1/2016 11:00,52712,8709,513,4712,38778,43369,-4591
8/1/2016 12:00,56521,7802,518,4712,43489,46697,-3208
8/1/2016 13:00,59913,7569,510,4712,47122,48623,-1501
8/1/2016 14:00,62865,7966,513,4712,49673,49565,108
8/1/2016 15:00,65214,8408,504,4712,51590,49976,1614
8/1/2016 16:00,66701,8778,476,4712,52736,49292,3444
8/1/2016 17:00,67269,9002,423,4712,53132,47636,5496
8/1/2016 18:00,66871,9401,316,4712,52442,45595,6847
8/1/2016 19:00,65390,8478,146,4712,52054,43755,8299
8/1/2016 20:00,62757,8651,0,4712,49393,40816,8577
8/1/2016 21:00,60182,9902,0,4712,45568,36023,9545
8/1/2016 22:00,57952,10452,0,4712,42788,31457,11331
8/1/2016 23:00,53748,10657,0,4712,38379,28432,9947
8/2/2016 0:00,49179,10204,0,4712,34263,26384,7879
8/2/2016 1:00,45382,9252,0,4712,31418,25132,6286
8/2/2016 2:00,42570,9180,0,4712,28679,24020,4659
8/2/2016 3:00,40605,9071,0,4712,26822,23791,3031
8/2/2016 4:00,39375,9007,0,4712,25656,24571,1085
8/2/2016 5:00,39015,8879,0,4712,25424,26029,-605
8/2/2016 6:00,39887,8125,0,4712,27050,27899,-849
8/2/2016 7:00,41448,6206,236,4712,30294,31866,-1572
8/2/2016 8:00,42363,5797,403,4712,31451,35103,-3652
8/2/2016 9:00,45151,5362,472,4712,34606,39455,-4849
8/2/2016 10:00,48910,4008,482,4712,39708,44264,-4556
8/2/2016 11:00,52823,3025,510,4712,44576,48253,-3677
8/2/2016 12:00,56666,2374,519,4712,49061,51372,-2311
8/2/2016 13:00,60117,2684,514,4712,52208,53084,-876
8/2/2016 14:00,63301,3263,510,4712,54816,54212,604
8/2/2016 15:00,65639,3745,514,4712,56667,54334,2333
8/2/2016 16:00,67004,4475,490,4712,57327,53181,4146
8/2/2016 17:00,67486,5962,440,4712,56372,51219,5153
8/2/2016 18:00,67288,6541,309,4712,55726,48641,7085
8/2/2016 19:00,65996,6122,162,4712,55001,47087,7914
8/2/2016 20:00,63508,5719,0,4712,53077,44394,8683
8/2/2016 21:00,61156,6628,0,4712,49817,40250,9567
8/2/2016 22:00,58810,7328,0,4712,46770,34950,11820
8/2/2016 23:00,54593,6960,0,4712,42921,32313,10608
8/3/2016 0:00,50088,6533,0,4712,38843,29903,8940
8/3/2016 1:00,46274,6205,0,4712,35357,27995,7362
8/3/2016 2:00,43470,6260,0,4712,32498,27201,5297
8/3/2016 3:00,41462,5413,0,4712,31337,27447,3890
8/3/2016 4:00,40168,4837,0,4712,30619,28395,2224
8/3/2016 5:00,39735,4528,0,4712,30494,29977,517
8/3/2016 6:00,40579,4399,0,4712,31468,31370,98
8/3/2016 7:00,42246,3581,200,4712,33754,34574,-820
8/3/2016 8:00,43208,3254,386,4712,34856,37872,-3016
8/3/2016 9:00,46173,3001,465,4712,37996,42761,-4765
8/3/2016 10:00,50064,2228,497,4712,42627,47161,-4534
8/3/2016 11:00,54252,1774,517,4712,47249,50503,-3254
8/3/2016 12:00,58485,1967,512,4712,51294,52895,-1601
8/3/2016 13:00,62050,2312,514,4712,54511,55068,-557
8/3/2016 14:00,65204,2633,515,4712,57344,55814,1530
8/3/2016 15:00,67564,2844,506,4712,59503,55793,3710
8/3/2016 16:00,68624,3169,459,4712,60283,55379,4904
8/3/2016 17:00,68790,3605,362,4712,60111,54017,6094
8/3/2016 18:00,68590,4301,316,4712,59261,51105,8156
8/3/2016 19:00,67540,5177,213,4712,57438,48632,8806
8/3/2016 20:00,65207,5515,0,4712,54980,45427,9553
8/3/2016 21:00,62825,6637,0,4712,51476,40476,11000
8/3/2016 22:00,60379,7870,0,4712,47797,35231,12566
8/3/2016 23:00,56156,8624,0,4712,42820,30912,11908
8/4/2016 0:00,51509,9625,0,4712,37172,28255,8917
8/4/2016 1:00,47342,9543,0,4712,33087,26526,6561
8/4/2016 2:00,44309,9310,0,4712,30287,25331,4956
8/4/2016 3:00,42138,8989,0,4712,28437,25066,3371
8/4/2016 4:00,40694,8653,0,4712,27329,26126,1203
8/4/2016 5:00,40227,8740,0,4712,26775,27772,-997
8/4/2016 6:00,41078,8376,0,4712,27990,28931,-941
8/4/2016 7:00,42559,7715,183,4712,29948,31680,-1732
8/4/2016 8:00,43554,7531,335,4712,30976,34077,-3101
8/4/2016 9:00,46369,7792,435,4712,33431,38937,-5506
8/4/2016 10:00,50349,5858,490,4712,39289,44290,-5001
8/4/2016 11:00,54662,4363,512,4712,45075,48299,-3224
8/4/2016 12:00,58738,4118,509,4712,49399,51623,-2224
8/4/2016 13:00,62267,4191,511,4712,52852,53892,-1040
8/4/2016 14:00,65406,4118,510,4712,56066,54867,1199
8/4/2016 15:00,67573,4390,500,4712,57971,54718,3253
8/4/2016 16:00,68664,4399,432,4712,59121,53945,5176
8/4/2016 17:00,68638,5066,416,4712,58443,52414,6029
8/4/2016 18:00,68187,5593,307,4712,57575,49832,7743
8/4/2016 19:00,66995,6008,199,4712,56077,47293,8784
8/4/2016 20:00,64567,6795,0,4712,53060,44169,8891
8/4/2016 21:00,62329,7957,0,4712,49660,38860,10800
8/4/2016 22:00,60156,9262,0,4712,46182,34412,11770
8/4/2016 23:00,56052,9798,0,4712,41542,30685,10857
8/5/2016 0:00,51562,10453,0,4712,36396,28322,8074
8/5/2016 1:00,47804,10194,0,4712,32899,26933,5966
8/5/2016 2:00,44924,9383,0,4712,30829,26797,4032
8/5/2016 3:00,42751,8142,0,4712,29897,27239,2658
8/5/2016 4:00,41355,7094,0,4712,29550,28528,1022
8/5/2016 5:00,40970,6331,0,4712,29926,30345,-419
8/5/2016 6:00,41728,5952,0,4712,31064,31838,-774
8/5/2016 7:00,43127,4177,162,4712,34075,35415,-1340
8/5/2016 8:00,43942,3551,307,4712,35372,37718,-2346
8/5/2016 9:00,46677,3831,366,4712,37769,42596,-4827
8/5/2016 10:00,50496,2408,489,4712,42887,47356,-4469
8/5/2016 11:00,54651,1610,511,4712,47818,50679,-2861
8/5/2016 12:00,58624,1493,520,4712,51899,53769,-1870
8/5/2016 13:00,62013,2108,514,4712,54679,55450,-771
8/5/2016 14:00,65066,2443,515,4712,57396,56376,1020
8/5/2016 15:00,67289,2924,507,4712,59146,56091,3055
8/5/2016 16:00,68495,3530,432,4712,59821,54917,4904
8/5/2016 17:00,68690,4242,425,4712,59310,52557,6753
8/5/2016 18:00,68247,5186,318,4712,58031,49933,8098
8/5/2016 19:00,66500,5175,122,4712,56492,47458,9034
8/5/2016 20:00,63877,5698,0,4712,53468,44721,8747
8/5/2016 21:00,61610,6737,0,4712,50161,39851,10310
8/5/2016 22:00,59398,7839,0,4712,46848,35507,11341
8/5/2016 23:00,55684,8248,0,4712,42725,32086,10639
8/6/2016 0:00,51776,8961,0,4712,38102,29811,8291
8/6/2016 1:00,48114,8270,0,4712,35132,28784,6348
8/6/2016 2:00,45216,7729,0,4712,32774,28049,4725
8/6/2016 3:00,43155,6872,0,4712,31571,27640,3931
8/6/2016 4:00,41560,6444,0,4712,30405,27881,2524
8/6/2016 5:00,40494,5883,0,4712,29899,28402,1497
8/6/2016 6:00,40209,5086,0,4712,30411,29561,850
8/6/2016 7:00,40272,3446,156,4712,31958,33932,-1974
8/6/2016 8:00,40665,2563,303,4712,33088,37672,-4584
8/6/2016 9:00,43958,2591,393,4712,36261,42081,-5820
8/6/2016 10:00,48508,2142,471,4712,41183,46214,-5031
8/6/2016 11:00,53001,1662,509,4712,46118,48935,-2817
8/6/2016 12:00,57063,2159,519,4712,49672,50951,-1279
8/6/2016 13:00,60281,2623,516,4712,52431,52466,-35
8/6/2016 14:00,62816,2856,510,4712,54738,53489,1249
8/6/2016 15:00,64461,3139,513,4712,56096,53681,2415
8/6/2016 16:00,65696,3747,494,4712,56743,53273,3470
8/6/2016 17:00,66376,4334,445,4712,56886,51875,5011
8/6/2016 18:00,66411,5292,351,4712,56055,49100,6955
8/6/2016 19:00,65122,5453,162,4712,54796,46806,7990
8/6/2016 20:00,62663,5815,0,4712,52136,43694,8442
8/6/2016 21:00,60452,7003,0,4712,48737,39678,9059
8/6/2016 22:00,58368,7248,0,4712,46407,35344,11063
8/6/2016 23:00,54837,8259,0,4712,41865,32026,9839
8/7/2016 0:00,51289,8358,0,4712,38219,29928,8291
8/7/2016 1:00,47949,8058,0,4712,35179,28657,6522
8/7/2016 2:00,45154,7510,0,4712,32932,27692,5240
8/7/2016 3:00,42925,6927,0,4712,31286,26951,4335
8/7/2016 4:00,41284,6400,0,4712,30172,26841,3331
8/7/2016 5:00,40092,6201,0,4712,29179,26903,2276
8/7/2016 6:00,39559,5718,0,4712,29129,27432,1697
8/7/2016 7:00,39249,4918,179,4712,29440,30397,-957
8/7/2016 8:00,39177,4789,282,4712,29395,33724,-4329
8/7/2016 9:00,42229,5303,357,4712,31857,37794,-5937
8/7/2016 10:00,46726,4415,438,4712,37161,43085,-5924
8/7/2016 11:00,51362,2825,516,4712,43309,47204,-3895
8/7/2016 12:00,55594,2420,522,4712,47940,49692,-1752
8/7/2016 13:00,59247,2821,516,4712,51198,51902,-704
8/7/2016 14:00,62251,3060,518,4712,53961,52950,1011
8/7/2016 15:00,64482,3277,511,4712,55982,53328,2654
8/7/2016 16:00,65904,4327,486,4712,56378,52648,3730
8/7/2016 17:00,66738,4988,428,4712,56610,51639,4971
8/7/2016 18:00,66921,5282,303,4712,56624,49991,6633
8/7/2016 19:00,65886,5055,124,4712,55995,47712,8283
8/7/2016 20:00,63649,5513,0,4712,53424,44821,8603
8/7/2016 21:00,61676,6639,0,4712,50325,40296,10029
8/7/2016 22:00,59562,6851,0,4712,47999,35939,12060
8/7/2016 23:00,55707,7214,0,4712,43781,33043,10738
8/8/2016 0:00,51575,7191,0,4712,39672,30399,9273
8/8/2016 1:00,47831,7435,0,4712,35684,29257,6427
8/8/2016 2:00,45014,6530,0,4712,33773,28459,5314
8/8/2016 3:00,43037,6445,0,4712,31879,28591,3288
8/8/2016 4:00,41776,5944,0,4712,31120,29493,1627
8/8/2016 5:00,41492,6052,0,4712,30728,31481,-753
8/8/2016 6:00,42439,5451,0,4712,32275,32396,-121
8/8/2016 7:00,44138,4790,157,4712,34478,35304,-826
8/8/2016 8:00,44834,4420,300,4712,35403,38732,-3329
8/8/2016 9:00,47584,3940,347,4712,38585,43263,-4678
8/8/2016 10:00,51463,3484,431,4712,42836,47782,-4946
8/8/2016 11:00,55818,2505,508,4712,48093,51435,-3342
8/8/2016 12:00,60009,2702,518,4712,52077,54222,-2145
8/8/2016 13:00,63690,3613,512,4712,54853,55783,-930
8/8/2016 14:00,66850,4727,516,4712,56895,56108,787
8/8/2016 15:00,69005,4991,491,4712,58811,55786,3025
8/8/2016 16:00,69966,6179,471,4712,58605,54206,4399
8/8/2016 17:00,70093,6318,423,4712,58640,53148,5492
8/8/2016 18:00,69634,6842,313,4712,57767,50148,7619
8/8/2016 19:00,68123,7362,112,4712,55938,47700,8238
8/8/2016 20:00,65808,7554,0,4712,53542,45106,8436
8/8/2016 21:00,63762,7575,0,4712,51475,41214,10261
8/8/2016 22:00,60972,6624,0,4712,49636,37289,12347
8/8/2016 23:00,56438,6952,0,4712,44774,33985,10789
8/9/2016 0:00,51867,7444,0,4712,39711,32054,7657
8/9/2016 1:00,48126,7072,0,4712,36342,30269,6073
8/9/2016 2:00,45478,7849,0,4712,32917,28621,4296
8/9/2016 3:00,43598,8167,0,4712,30719,28593,2126
8/9/2016 4:00,42334,7296,0,4712,30326,30638,-312
8/9/2016 5:00,41940,5373,0,4712,31855,33778,-1923
8/9/2016 6:00,42969,3996,0,4712,34261,35284,-1023
8/9/2016 7:00,44723,2863,127,4712,37022,37302,-280
8/9/2016 8:00,45438,2640,221,4712,37865,39805,-1940
8/9/2016 9:00,47885,3112,287,4712,39773,44224,-4451
8/9/2016 10:00,51672,2974,430,4712,43556,47875,-4319
8/9/2016 11:00,55909,3322,513,4712,47362,50466,-3104
8/9/2016 12:00,59822,3298,519,4712,51293,53387,-2094
8/9/2016 13:00,63453,3448,516,4712,54777,54794,-17
8/9/2016 14:00,66582,4257,520,4712,57093,55736,1357
8/9/2016 15:00,68687,4822,512,4712,58641,55451,3190
8/9/2016 16:00,69565,5695,483,4712,58674,54135,4539
8/9/2016 17:00,69851,6568,416,4712,58155,52930,5225
8/9/2016 18:00,69355,6489,317,4712,57837,50694,7143
8/9/2016 19:00,67995,5984,112,4712,57187,49144,8043
8/9/2016 20:00,65597,6144,0,4712,54741,46771,7970
8/9/2016 21:00,63567,6421,0,4712,52434,42370,10064
8/9/2016 22:00,61206,6732,0,4712,49762,38242,11520
8/9/2016 23:00,57046,6861,0,4712,45473,35357,10116
8/10/2016 0:00,52709,6659,0,4712,41338,33161,8177
8/10/2016 1:00,48863,5834,0,4712,38317,32049,6268
8/10/2016 2:00,46156,5412,0,4712,36032,31219,4813
8/10/2016 3:00,44267,5736,0,4712,33819,30079,3740
8/10/2016 4:00,43025,6771,0,4712,31542,30964,578
8/10/2016 5:00,42630,5984,0,4712,31934,33253,-1319
8/10/2016 6:00,43594,5685,0,4712,33198,33885,-687
8/10/2016 7:00,45370,5160,150,4712,35348,35978,-630
8/10/2016 8:00,45958,5003,303,4712,35940,38180,-2240
8/10/2016 9:00,48562,6183,421,4712,37246,42299,-5053
8/10/2016 10:00,52477,6190,489,4712,41085,45972,-4887
8/10/2016 11:00,56792,5619,515,4712,45946,49714,-3768
8/10/2016 12:00,60873,4729,525,4712,50907,53073,-2166
8/10/2016 13:00,64508,4381,507,4712,54908,55094,-186
8/10/2016 14:00,67630,5445,518,4712,56955,55186,1769
8/10/2016 15:00,69740,5726,499,4712,58803,55497,3306
8/10/2016 16:00,70460,5638,500,4712,59611,55074,4537
8/10/2016 17:00,70513,5574,451,4712,59776,54401,5375
8/10/2016 18:00,70126,5758,341,4712,59315,52306,7009
8/10/2016 19:00,68913,5439,144,4712,58618,50304,8314
8/10/2016 20:00,66616,5942,0,4712,55962,47364,8598
8/10/2016 21:00,64695,6615,0,4712,53368,42747,10621
8/10/2016 22:00,62098,7067,0,4712,50319,38885,11434
8/10/2016 23:00,57903,6927,0,4712,46264,36033,10231
8/11/2016 0:00,53612,7158,0,4712,41742,33469,8273
8/11/2016 1:00,49846,6683,0,4712,38451,31714,6737
8/11/2016 2:00,47074,6863,0,4712,35499,30518,4981
8/11/2016 3:00,45000,6786,0,4712,33502,30289,3213
8/11/2016 4:00,43679,6915,0,4712,32052,31462,590
8/11/2016 5:00,43270,6293,0,4712,32264,33577,-1313
8/11/2016 6:00,44272,5947,0,4712,33612,34259,-647
8/11/2016 7:00,45951,5421,179,4712,35639,36590,-951
8/11/2016 8:00,46517,5129,388,4712,36289,38966,-2677
8/11/2016 9:00,48887,6192,469,4712,37513,42849,-5336
8/11/2016 10:00,52726,5480,500,4712,42034,47056,-5022
8/11/2016 11:00,56910,4908,521,4712,46770,50871,-4101
8/11/2016 12:00,61059,3462,524,4712,52362,54503,-2141
8/11/2016 13:00,64559,3553,518,4712,55776,56602,-826
8/11/2016 14:00,67795,3971,517,4712,58595,57110,1485
8/11/2016 15:00,70200,4343,505,4712,60640,57087,3553
8/11/2016 16:00,70990,5244,475,4712,60558,55725,4833
8/11/2016 17:00,71093,5916,412,4712,60052,53958,6094
8/11/2016 18:00,70754,7270,303,4712,58469,51460,7009
8/11/2016 19:00,69414,6593,164,4712,57945,50171,7774
8/11/2016 20:00,67102,7202,0,4712,55188,47772,7416
8/11/2016 21:00,64906,6538,0,4712,53656,43839,9817
8/11/2016 22:00,62281,6125,0,4712,51444,40303,11141
8/11/2016 23:00,57977,5642,0,4712,47623,38296,9327
8/12/2016 0:00,53611,5203,0,4712,43696,35863,7833
8/12/2016 1:00,49726,5366,0,4712,39647,34115,5532
8/12/2016 2:00,46834,4501,0,4712,37620,33833,3787
8/12/2016 3:00,44693,3452,0,4712,36530,33968,2562
8/12/2016 4:00,43377,2894,0,4712,35771,34881,890
8/12/2016 5:00,42813,3075,0,4712,35026,36396,-1370
8/12/2016 6:00,43703,3286,0,4712,35705,36717,-1012
8/12/2016 7:00,45463,4034,202,4712,36516,38034,-1518
8/12/2016 8:00,45919,4084,395,4712,36728,40693,-3965
8/12/2016 9:00,48267,3970,471,4712,39113,44669,-5556
8/12/2016 10:00,51904,3403,482,4712,43307,48954,-5647
8/12/2016 11:00,56213,3294,506,4712,47701,51938,-4237
8/12/2016 12:00,60412,3872,512,4712,51316,53656,-2340
8/12/2016 13:00,64357,5166,511,4712,53967,54883,-916
8/12/2016 14:00,67795,5374,498,4712,57210,55653,1557
8/12/2016 15:00,69857,6029,486,4712,58630,54128,4502
8/12/2016 16:00,70282,6134,448,4712,58988,52408,6580
8/12/2016 17:00,69207,5482,406,4712,58607,50028,8579
8/12/2016 18:00,66739,5596,311,4712,56120,48337,7783
8/12/2016 19:00,63761,4557,127,4712,54365,47085,7280
8/12/2016 20:00,60471,4161,0,4712,51598,45030,6568
8/12/2016 21:00,58612,3633,0,4712,50266,41887,8379
8/12/2016 22:00,56154,2895,0,4712,48547,38932,9615
8/12/2016 23:00,52579,2339,0,4712,45528,36337,9191
8/13/2016 0:00,48903,2111,0,4712,42080,34450,7630
8/13/2016 1:00,45621,2093,0,4712,38816,33035,5781
8/13/2016 2:00,43220,1580,0,4712,36928,32415,4513
8/13/2016 3:00,41371,1256,0,4712,35403,31908,3495
8/13/2016 4:00,40103,1418,0,4712,33973,32023,1950
8/13/2016 5:00,39419,1323,0,4712,33384,32745,639
8/13/2016 6:00,39560,1481,0,4712,33367,32701,666
8/13/2016 7:00,40213,2333,176,4712,32992,33099,-107
8/13/2016 8:00,40527,3385,371,4712,32059,34042,-1983
8/13/2016 9:00,42056,5150,457,4712,31737,35729,-3992
8/13/2016 10:00,44348,5526,445,4712,33665,37446,-3781
8/13/2016 11:00,47107,6317,506,4712,35572,39096,-3524
8/13/2016 12:00,49956,6893,513,4712,37837,41222,-3385
8/13/2016 13:00,52804,6989,510,4712,40593,42608,-2015
8/13/2016 14:00,55312,6608,506,4712,43486,43311,175
8/13/2016 15:00,57175,6409,485,4712,45569,44202,1367
8/13/2016 16:00,58116,5648,400,4712,47357,44593,2764
8/13/2016 17:00,58430,5016,333,4712,48370,43156,5214
8/13/2016 18:00,58133,4837,245,4712,48340,41040,7300
8/13/2016 19:00,56076,4581,133,4712,46651,39869,6782
8/13/2016 20:00,53637,4330,0,4712,44594,38214,6380
8/13/2016 21:00,51916,4126,0,4712,43078,35738,7340
8/13/2016 22:00,49986,3521,0,4712,41753,34058,7695
8/13/2016 23:00,47338,3488,0,4712,39138,31825,7313
8/14/2016 0:00,44350,3454,0,4712,36183,30286,5897
8/14/2016 1:00,41668,3150,0,4712,33806,28693,5113
8/14/2016 2:00,39548,2951,0,4712,31885,28151,3734
8/14/2016 3:00,37950,2456,0,4712,30782,28132,2650
8/14/2016 4:00,36797,2076,0,4712,30009,28382,1627
8/14/2016 5:00,36075,1669,0,4712,29694,28571,1123
8/14/2016 6:00,35873,1951,0,4712,29210,28525,685
8/14/2016 7:00,35987,1754,214,4712,29307,30587,-1280
8/14/2016 8:00,35994,1425,359,4712,29497,32761,-3264
8/14/2016 9:00,37843,1904,410,4712,30818,34398,-3580
8/14/2016 10:00,40373,3161,485,4712,32016,35574,-3558
8/14/2016 11:00,43207,4254,510,4712,33731,36400,-2669
8/14/2016 12:00,45873,5019,507,4712,35636,36965,-1329
8/14/2016 13:00,48040,5488,507,4712,37332,37698,-366
8/14/2016 14:00,49363,5273,499,4712,38878,38385,493
8/14/2016 15:00,50134,4931,478,4712,40013,38451,1562
8/14/2016 16:00,50829,5352,429,4712,40336,38267,2069
8/14/2016 17:00,50903,5384,326,4712,40482,38163,2319
8/14/2016 18:00,50456,4165,240,4712,41338,37921,3417
8/14/2016 19:00,49309,3024,117,4712,41456,38003,3453
8/14/2016 20:00,48011,2611,0,4712,40687,36815,3872
8/14/2016 21:00,47699,2490,0,4712,40496,34571,5925
8/14/2016 22:00,46537,2145,0,4712,39680,32395,7285
8/14/2016 23:00,43880,1931,0,4712,37238,30813,6425
8/15/2016 0:00,40714,1677,0,4712,34325,29212,5113
8/15/2016 1:00,38131,1504,0,4712,31915,28376,3539
8/15/2016 2:00,36405,1357,0,4712,30336,27859,2477
8/15/2016 3:00,35386,1220,0,4712,29454,28095,1359
8/15/2016 4:00,34865,1202,0,4712,28951,29364,-413
8/15/2016 5:00,35222,1254,0,4712,29256,31203,-1947
8/15/2016 6:00,36690,1064,0,4712,30914,32591,-1677
8/15/2016 7:00,39003,980,181,4712,33130,33857,-727
8/15/2016 8:00,39968,447,307,4712,34502,35536,-1034
8/15/2016 9:00,41129,304,390,4712,35722,36810,-1088
8/15/2016 10:00,42891,447,487,4712,37246,37038,208
8/15/2016 11:00,44470,710,506,4712,38541,36820,1721
8/15/2016 12:00,45330,1054,478,4712,39086,36957,2129
8/15/2016 13:00,45724,1207,494,4712,39310,37297,2013
8/15/2016 14:00,46180,1350,497,4712,39621,37672,1949
8/15/2016 15:00,46851,1545,481,4712,40112,38040,2072
8/15/2016 16:00,47694,1987,410,4712,40586,38068,2518
8/15/2016 17:00,48467,2157,280,4712,41319,37795,3524
8/15/2016 18:00,48646,2806,202,4712,40926,36458,4468
8/15/2016 19:00,47854,2975,80,4712,40087,35494,4593
8/15/2016 20:00,46647,3706,0,4712,38229,33325,4904
8/15/2016 21:00,46581,4798,0,4712,37072,30589,6483
8/15/2016 22:00,45410,5435,0,4712,35263,27716,7547
8/15/2016 23:00,42522,5289,0,4712,32520,25731,6789
8/16/2016 0:00,39289,4849,0,4712,29728,24871,4857
8/16/2016 1:00,36684,3903,0,4712,28069,24455,3614
8/16/2016 2:00,35007,3242,0,4712,27053,24539,2514
8/16/2016 3:00,33949,2510,0,4712,26727,25239,1488
8/16/2016 4:00,33438,2014,0,4712,26712,27120,-408
8/16/2016 5:00,33672,1579,0,4712,27381,29531,-2150
8/16/2016 6:00,35285,1616,0,4712,28957,30737,-1780
8/16/2016 7:00,37854,1440,131,4712,31572,31713,-141
8/16/2016 8:00,38925,741,370,4712,33102,33571,-469
8/16/2016 9:00,40026,683,467,4712,34164,34697,-533
8/16/2016 10:00,41583,796,468,4712,35608,35695,-87
8/16/2016 11:00,43098,729,499,4712,37158,35798,1360
8/16/2016 12:00,44463,1339,509,4712,37904,36059,1845
8/16/2016 13:00,45560,2028,492,4712,38329,37042,1287
8/16/2016 14:00,46792,2039,498,4712,39542,37572,1970
8/16/2016 15:00,47891,2175,479,4712,40526,37953,2573
8/16/2016 16:00,48556,2448,383,4712,41013,37751,3262
8/16/2016 17:00,48974,2713,362,4712,41187,36785,4402
8/16/2016 18:00,48761,2888,272,4712,40889,35929,4960
8/16/2016 19:00,47928,3387,112,4712,39717,35631,4086
8/16/2016 20:00,46962,3533,0,4712,38717,34417,4300
8/16/2016 21:00,47027,3950,0,4712,38365,32436,5929
8/16/2016 22:00,46028,4146,0,4712,37169,29731,7438
8/16/2016 23:00,43412,3863,0,4712,34837,27899,6938
8/17/2016 0:00,40349,3642,0,4712,31995,26969,5026
8/17/2016 1:00,37801,3104,0,4712,29985,26411,3574
8/17/2016 2:00,36247,2415,0,4712,29120,26588,2532
8/17/2016 3:00,35247,1747,0,4712,28788,27267,1521
8/17/2016 4:00,34776,1481,0,4712,28583,28989,-406
8/17/2016 5:00,35010,1061,0,4712,29236,31009,-1773
8/17/2016 6:00,36641,975,0,4712,30954,31369,-415
8/17/2016 7:00,39259,741,222,4712,33585,32293,1292
8/17/2016 8:00,40178,481,404,4712,34581,34201,380
8/17/2016 9:00,41030,683,448,4712,35187,35669,-482
8/17/2016 10:00,42640,876,484,4712,36568,37152,-584
8/17/2016 11:00,44898,1017,511,4712,38658,38382,276
8/17/2016 12:00,46778,776,515,4712,40775,38913,1862
8/17/2016 13:00,47986,879,509,4712,41885,39130,2755
8/17/2016 14:00,48693,1380,513,4712,42087,39272,2815
8/17/2016 15:00,49187,1808,503,4712,42164,38607,3557
8/17/2016 16:00,49694,2830,476,4712,41676,37160,4516
8/17/2016 17:00,49696,2888,419,4712,41678,36162,5516
8/17/2016 18:00,48399,3243,312,4712,40133,35505,4628
8/17/2016 19:00,47043,4096,97,4712,38137,34724,3413
8/17/2016 20:00,46027,4889,0,4712,36426,32948,3478
8/17/2016 21:00,45896,5136,0,4712,36048,30555,5493
8/17/2016 22:00,44739,4708,0,4712,35320,28186,7134
8/17/2016 23:00,41959,4035,0,4712,33212,26617,6595
8/18/2016 0:00,38958,3596,0,4712,30651,25518,5133
8/18/2016 1:00,36481,3414,0,4712,28355,24732,3623
8/18/2016 2:00,34971,3228,0,4712,27031,24384,2647
8/18/2016 3:00,34052,2741,0,4712,26599,24878,1721
8/18/2016 4:00,33662,2723,0,4712,26227,26412,-185
8/18/2016 5:00,34028,2566,0,4712,26751,28708,-1957
8/18/2016 6:00,35780,2734,0,4712,28334,29677,-1343
8/18/2016 7:00,38520,2407,131,4712,31270,31255,15
8/18/2016 8:00,39627,2270,235,4712,32410,33227,-817
8/18/2016 9:00,41188,2793,290,4712,33393,35254,-1861
8/18/2016 10:00,43592,3360,448,4712,35072,36942,-1870
8/18/2016 11:00,46408,3883,495,4712,37318,37808,-490
8/18/2016 12:00,48753,4033,507,4712,39502,38350,1152
8/18/2016 13:00,50374,4179,506,4712,40976,38827,2149
8/18/2016 14:00,51520,4389,497,4712,41922,38506,3416
8/18/2016 15:00,52146,4619,497,4712,42318,38712,3606
8/18/2016 16:00,52251,4463,469,4712,42607,37868,4739
8/18/2016 17:00,52265,5821,411,4712,41320,36072,5248
8/18/2016 18:00,51492,6711,307,4712,39761,34130,5631
8/18/2016 19:00,50075,7177,71,4712,38115,33731,4384
8/18/2016 20:00,48546,7168,0,4712,36666,32217,4449
8/18/2016 21:00,48374,7606,0,4712,36056,29037,7019
8/18/2016 22:00,47110,8865,0,4712,33534,25668,7866
8/18/2016 23:00,44178,8558,0,4712,30908,23579,7329
8/19/2016 0:00,40863,8087,0,4712,28064,22170,5894
8/19/2016 1:00,38166,7817,0,4712,25636,21957,3679
8/19/2016 2:00,36325,6471,0,4712,25142,22239,2903
8/19/2016 3:00,35241,5632,0,4712,24897,23289,1608
8/19/2016 4:00,34690,4963,0,4712,25015,25096,-81
8/19/2016 5:00,34947,4654,0,4712,25582,27403,-1821
8/19/2016 6:00,36452,4537,0,4712,27203,29303,-2100
8/19/2016 7:00,38994,4126,92,4712,30065,31322,-1257
8/19/2016 8:00,40209,4490,242,4712,30766,32304,-1538
8/19/2016 9:00,42103,6615,278,4712,30498,33651,-3153
8/19/2016 10:00,44933,7294,372,4712,32555,35449,-2894
8/19/2016 11:00,47753,7101,493,4712,35447,37094,-1647
8/19/2016 12:00,50242,7628,497,4712,37405,37944,-539
8/19/2016 13:00,52023,6890,494,4712,39927,39292,635
8/19/2016 14:00,53310,6719,475,4712,41404,39108,2296
8/19/2016 15:00,54312,6778,467,4712,42355,38526,3829
8/19/2016 16:00,54382,6627,432,4712,42610,37057,5553
8/19/2016 17:00,53552,6973,340,4712,41527,35896,5631
8/19/2016 18:00,52181,7003,212,4712,40255,34573,5682
8/19/2016 19:00,50633,6502,35,4712,39384,34054,5330
8/19/2016 20:00,48806,7377,0,4712,36717,32499,4218
8/19/2016 21:00,48337,7326,0,4712,36299,29784,6515
8/19/2016 22:00,47055,8188,0,4712,34155,26879,7276
8/19/2016 23:00,44595,8386,0,4712,31497,25054,6443
8/20/2016 0:00,41658,7442,0,4712,29504,23832,5672
8/20/2016 1:00,38987,5969,0,4712,28306,23276,5030
8/20/2016 2:00,37027,6296,0,4712,26020,23061,2959
8/20/2016 3:00,35678,4871,0,4712,26095,23431,2664
8/20/2016 4:00,34963,4850,0,4712,25401,24263,1138
8/20/2016 5:00,34781,3908,0,4712,26162,25619,543
8/20/2016 6:00,35166,3691,0,4712,26763,26207,556
8/20/2016 7:00,36071,4230,33,4712,27097,27508,-411
8/20/2016 8:00,36870,5290,109,4712,26759,29365,-2606
8/20/2016 9:00,39038,5576,202,4712,28549,31689,-3140
8/20/2016 10:00,41589,5090,279,4712,31508,33838,-2330
8/20/2016 11:00,44108,4323,482,4712,34592,35131,-539
8/20/2016 12:00,45967,4176,495,4712,36583,34986,1597
8/20/2016 13:00,47048,4420,489,4712,37427,35195,2232
8/20/2016 14:00,47292,4167,468,4712,37945,36267,1678
8/20/2016 15:00,47752,4195,457,4712,38388,36639,1749
8/20/2016 16:00,48629,4499,407,4712,39011,36722,2289
8/20/2016 17:00,49088,4108,269,4712,39999,36459,3540
8/20/2016 18:00,48893,3742,171,4712,40268,36105,4163
8/20/2016 19:00,48019,3205,62,4712,40040,36240,3800
8/20/2016 20:00,46853,3010,0,4712,39131,35134,3997
8/20/2016 21:00,46667,3037,0,4712,38918,33301,5617
8/20/2016 22:00,45410,2815,0,4712,37883,30205,7678
8/20/2016 23:00,43054,3237,0,4712,35105,28075,7030
8/21/2016 0:00,40366,2695,0,4712,32959,27202,5757
8/21/2016 1:00,37967,2334,0,4712,30922,26526,4396
8/21/2016 2:00,36255,1938,0,4712,29605,25767,3838
8/21/2016 3:00,34905,1809,0,4712,28384,25379,3005
8/21/2016 4:00,34003,1787,0,4712,27504,25416,2088
8/21/2016 5:00,33552,1817,0,4712,27022,25799,1223
8/21/2016 6:00,33558,1527,0,4712,27319,25984,1335
8/21/2016 7:00,33929,1605,192,4712,27421,27475,-54
8/21/2016 8:00,33982,1361,308,4712,27601,29476,-1875
8/21/2016 9:00,35614,1663,393,4712,28846,31293,-2447
8/21/2016 10:00,38047,1934,471,4712,30930,33007,-2077
8/21/2016 11:00,40509,2287,495,4712,33014,34892,-1878
8/21/2016 12:00,43003,1969,498,4712,35823,35814,9
8/21/2016 13:00,45017,2321,503,4712,37482,36334,1148
8/21/2016 14:00,46325,2341,499,4712,38773,37833,940
8/21/2016 15:00,47334,2571,487,4712,39564,38598,966
8/21/2016 16:00,48594,2476,454,4712,40952,38909,2043
8/21/2016 17:00,49551,2443,370,4712,42026,38221,3805
8/21/2016 18:00,49806,2722,276,4712,42097,37071,5026
8/21/2016 19:00,49220,3098,52,4712,41357,36685,4672
8/21/2016 20:00,48068,3673,0,4712,39683,34782,4901
8/21/2016 21:00,47938,4509,0,4712,38718,31102,7616
8/21/2016 22:00,46359,4551,0,4712,37096,27671,9425
8/21/2016 23:00,42975,4632,0,4712,33631,25344,8287
8/22/2016 0:00,39285,4596,0,4712,29978,23996,5982
8/22/2016 1:00,36608,4256,0,4712,27640,23035,4605
8/22/2016 2:00,34884,4157,0,4712,26015,22718,3297
8/22/2016 3:00,33884,3827,0,4712,25345,23611,1734
8/22/2016 4:00,33545,3319,0,4712,25514,25832,-318
8/22/2016 5:00,34006,3022,0,4712,26273,29288,-3015
8/22/2016 6:00,35914,2774,0,4712,28427,30050,-1623
8/22/2016 7:00,39190,2593,115,4712,31770,31310,460
8/22/2016 8:00,39888,2021,256,4712,32900,33486,-586
8/22/2016 9:00,41054,3509,364,4712,32469,34690,-2221
8/22/2016 10:00,43630,4140,424,4712,34354,35680,-1326
8/22/2016 11:00,46079,4159,497,4712,36711,36417,294
8/22/2016 12:00,47452,4404,505,4712,37832,37920,-88
8/22/2016 13:00,48720,4538,503,4712,38967,38798,169
8/22/2016 14:00,50574,5297,503,4712,40062,38389,1673
8/22/2016 15:00,52175,6173,489,4712,40801,39156,1645
8/22/2016 16:00,52981,5804,405,4712,42060,38865,3195
8/22/2016 17:00,53625,6827,385,4712,41701,37475,4226
8/22/2016 18:00,53767,7637,280,4712,41138,36225,4913
8/22/2016 19:00,52875,7680,61,4712,40422,35001,5421
8/22/2016 20:00,51402,10005,0,4712,36685,33132,3553
8/22/2016 21:00,51180,8680,0,4712,37788,29752,8036
8/22/2016 22:00,49350,9106,0,4712,35532,26253,9279
8/22/2016 23:00,45785,9109,0,4712,31964,23774,8190
8/23/2016 0:00,41938,9532,0,4712,27695,22115,5580
8/23/2016 1:00,39144,9986,0,4712,24446,21083,3363
8/23/2016 2:00,37525,9621,0,4712,23193,21370,1823
8/23/2016 3:00,36492,9116,0,4712,22664,21797,867
8/23/2016 4:00,36046,9260,0,4712,22074,23229,-1155
8/23/2016 5:00,36365,9592,0,4712,22061,25727,-3666
8/23/2016 6:00,38278,10094,0,4712,23472,26357,-2885
8/23/2016 7:00,41473,10211,78,4712,26473,27357,-884
8/23/2016 8:00,42008,10869,201,4712,26227,28573,-2346
8/23/2016 9:00,43660,12731,256,4712,25962,30981,-5019
8/23/2016 10:00,46595,12500,435,4712,28948,34187,-5239
8/23/2016 11:00,49993,11681,488,4712,33111,37185,-4074
8/23/2016 12:00,53149,10836,503,4712,37099,39968,-2869
8/23/2016 13:00,56050,10081,501,4712,40757,42280,-1523
8/23/2016 14:00,58763,9698,487,4712,43866,43423,443
8/23/2016 15:00,60572,9308,438,4712,46114,44425,1689
8/23/2016 16:00,61697,9385,400,4712,47201,43689,3512
8/23/2016 17:00,62416,10282,321,4712,47101,41807,5294
8/23/2016 18:00,61979,9274,182,4712,47811,39986,7825
8/23/2016 19:00,59895,9905,30,4712,45247,38409,6838
8/23/2016 20:00,57418,11081,0,4712,41625,35392,6233
8/23/2016 21:00,56493,11277,0,4712,40505,30735,9770
8/23/2016 22:00,53914,11329,0,4712,37873,27400,10473
8/23/2016 23:00,49466,10655,0,4712,34099,24966,9133
8/24/2016 0:00,45029,10538,0,4712,29779,23378,6401
8/24/2016 1:00,41788,9935,0,4712,27142,22241,4901
8/24/2016 2:00,39515,9995,0,4712,24809,21331,3478
8/24/2016 3:00,37973,9480,0,4712,23781,21897,1884
8/24/2016 4:00,37077,8358,0,4712,24007,24436,-429
8/24/2016 5:00,37030,7009,0,4712,25310,27812,-2502
8/24/2016 6:00,38550,5469,0,4712,28368,28411,-43
8/24/2016 7:00,41369,6066,144,4712,30446,29959,487
8/24/2016 8:00,41770,4802,329,4712,31927,32873,-946
8/24/2016 9:00,43259,4956,412,4712,33179,36094,-2915
8/24/2016 10:00,46228,5712,465,4712,35339,37957,-2618
8/24/2016 11:00,49768,7331,496,4712,37230,40646,-3416
8/24/2016 12:00,53285,7401,505,4712,40667,43621,-2954
8/24/2016 13:00,56621,7469,504,4712,43936,45745,-1809
8/24/2016 14:00,59501,7286,497,4712,47006,46058,948
8/24/2016 15:00,61520,7421,472,4712,48914,46456,2458
8/24/2016 16:00,62486,7942,468,4712,49364,45418,3946
8/24/2016 17:00,62952,8536,412,4712,49291,44171,5120
8/24/2016 18:00,62260,7799,313,4712,49435,42990,6445
8/24/2016 19:00,60557,6474,82,4712,49289,42768,6521
8/24/2016 20:00,57929,5390,0,4712,47827,40760,7067
8/24/2016 21:00,56498,5230,0,4712,46556,36067,10489
8/24/2016 22:00,53702,5781,0,4712,43210,31674,11536
8/24/2016 23:00,49279,5705,0,4712,38862,28683,10179
8/25/2016 0:00,44866,5909,0,4712,34245,26168,8077
8/25/2016 1:00,41373,6716,0,4712,29945,24913,5032
8/25/2016 2:00,38992,6525,0,4712,27756,23818,3938
8/25/2016 3:00,37406,6567,0,4712,26127,24219,1908
8/25/2016 4:00,36588,5982,0,4712,25894,26005,-111
8/25/2016 5:00,36529,5745,0,4712,26072,29396,-3324
8/25/2016 6:00,38122,4606,0,4712,28803,30466,-1663
8/25/2016 7:00,41057,3448,189,4712,32708,32778,-70
8/25/2016 8:00,41490,2952,390,4712,33435,35628,-2193
8/25/2016 9:00,42933,3219,468,4712,34534,39581,-5047
8/25/2016 10:00,46103,2831,470,4712,38089,42961,-4872
8/25/2016 11:00,49805,2560,503,4712,42029,45866,-3837
8/25/2016 12:00,53175,2205,510,4712,45748,48073,-2325
8/25/2016 13:00,56279,2044,507,4712,49016,49101,-85
8/25/2016 14:00,58888,2469,507,4712,51200,49218,1982
8/25/2016 15:00,60202,2891,497,4712,52102,48785,3317
8/25/2016 16:00,60987,3396,467,4712,52411,47945,4466
8/25/2016 17:00,61253,4286,406,4712,51849,45993,5856
8/25/2016 18:00,60335,5267,296,4712,50060,43640,6420
8/25/2016 19:00,58536,5441,47,4712,48336,41997,6339
8/25/2016 20:00,56280,6075,0,4712,45492,38879,6613
8/25/2016 21:00,55304,5821,0,4712,44771,34384,10387
8/25/2016 22:00,52703,5573,0,4712,42417,31167,11250
8/25/2016 23:00,48437,5411,0,4712,38315,28424,9891
8/26/2016 0:00,44266,4751,0,4712,34802,27285,7517
8/26/2016 1:00,40953,3877,0,4712,32364,26737,5627
8/26/2016 2:00,38686,3092,0,4712,30881,26739,4142
8/26/2016 3:00,37064,1970,0,4712,30382,27068,3314
8/26/2016 4:00,36120,1228,0,4712,30179,28846,1333
8/26/2016 5:00,36064,1008,0,4712,30344,31615,-1271
8/26/2016 6:00,37552,839,0,4712,32001,32373,-372
8/26/2016 7:00,40559,778,215,4712,34854,33382,1472
8/26/2016 8:00,41243,676,360,4712,35496,35334,162
8/26/2016 9:00,42218,1132,453,4712,35921,37785,-1864
8/26/2016 10:00,44559,969,483,4712,38395,41201,-2806
8/26/2016 11:00,47664,996,507,4712,41448,43263,-1815
8/26/2016 12:00,50814,1129,511,4712,44461,44868,-407
8/26/2016 13:00,53318,1234,508,4712,46863,45875,988
8/26/2016 14:00,55510,1371,504,4712,48924,45741,3183
8/26/2016 15:00,56778,2048,492,4712,49526,45770,3756
8/26/2016 16:00,57139,2319,447,4712,49661,44477,5184
8/26/2016 17:00,57265,2976,338,4712,49239,41869,7370
8/26/2016 18:00,56091,3224,255,4712,47901,39443,8458
8/26/2016 19:00,53418,3221,12,4712,45473,38010,7463
8/26/2016 20:00,50843,4162,0,4712,41969,36046,5923
8/26/2016 21:00,49675,3832,0,4712,41131,33066,8065
8/26/2016 22:00,47618,4087,0,4712,38819,29955,8864
8/26/2016 23:00,44660,4019,0,4712,35929,27511,8418
8/27/2016 0:00,41610,3968,0,4712,32930,26008,6922
8/27/2016 1:00,38707,3908,0,4712,30087,25214,4873
8/27/2016 2:00,36506,3366,0,4712,28428,24626,3802
8/27/2016 3:00,34961,3480,0,4712,26768,24137,2631
8/27/2016 4:00,34044,3396,0,4712,25936,24603,1333
8/27/2016 5:00,33550,2937,0,4712,25901,25408,493
8/27/2016 6:00,33741,2618,0,4712,26410,26245,165
8/27/2016 7:00,34510,2196,210,4712,27392,28876,-1484
8/27/2016 8:00,35099,1417,359,4712,28612,32000,-3388
8/27/2016 9:00,37460,1570,452,4712,30726,34793,-4067
8/27/2016 10:00,40912,1626,484,4712,34090,38515,-4425
8/27/2016 11:00,44419,1052,501,4712,38155,42175,-4020
8/27/2016 12:00,47758,691,506,4712,41849,44177,-2328
8/27/2016 13:00,50913,901,505,4712,44795,45187,-392
8/27/2016 14:00,53520,1677,504,4712,46627,45455,1172
8/27/2016 15:00,55518,2438,456,4712,47912,45350,2562
8/27/2016 16:00,56898,3187,462,4712,48537,45192,3345
8/27/2016 17:00,57576,3232,378,4712,49254,42537,6717
8/27/2016 18:00,57119,4708,264,4712,47435,40147,7288
8/27/2016 19:00,55021,4756,14,4712,45540,38714,6826
8/27/2016 20:00,52362,5272,0,4712,42377,35836,6541
8/27/2016 21:00,51144,5892,0,4712,40540,32625,7915
8/27/2016 22:00,48908,6157,0,4712,38039,29856,8183
8/27/2016 23:00,45945,5953,0,4712,35280,27716,7564
8/28/2016 0:00,42713,5591,0,4712,32410,26340,6070
8/28/2016 1:00,39843,5143,0,4712,29987,25645,4342
8/28/2016 2:00,37587,3869,0,4712,29007,25655,3352
8/28/2016 3:00,35957,2961,0,4712,28283,25619,2664
8/28/2016 4:00,34811,2404,0,4712,27694,25855,1839
8/28/2016 5:00,34044,1760,0,4712,27572,26348,1224
8/28/2016 6:00,33808,1532,0,4712,27564,26781,783
8/28/2016 7:00,34077,1163,153,4712,28050,28954,-904
8/28/2016 8:00,34236,567,373,4712,28585,32093,-3508
8/28/2016 9:00,36529,425,461,4712,30931,35161,-4230
8/28/2016 10:00,40075,340,487,4712,34536,38610,-4074
8/28/2016 11:00,43464,241,499,4712,38012,41670,-3658
8/28/2016 12:00,46929,680,512,4712,41025,43379,-2354
8/28/2016 13:00,50138,1147,511,4712,43767,44743,-976
8/28/2016 14:00,52748,1980,504,4712,45552,44667,885
8/28/2016 15:00,54565,2982,488,4712,46383,44501,1882
8/28/2016 16:00,55729,3423,443,4712,47151,43855,3296
8/28/2016 17:00,56171,4502,349,4712,46607,42262,4345
8/28/2016 18:00,55486,3923,318,4712,46533,41425,5108
8/28/2016 19:00,53817,2801,59,4712,46245,40467,5778
8/28/2016 20:00,51795,3422,0,4712,43661,38362,5299
8/28/2016 21:00,51016,3489,0,4712,42815,34462,8353
8/28/2016 22:00,48814,3860,0,4712,40242,30687,9555
8/28/2016 23:00,45086,3582,0,4712,36791,28343,8448
8/29/2016 0:00,41125,2925,0,4712,33488,26774,6714
8/29/2016 1:00,38081,2423,0,4712,30946,26387,4559
8/29/2016 2:00,36054,1688,0,4712,29654,26437,3217
8/29/2016 3:00,34839,1274,0,4712,28852,27019,1833
8/29/2016 4:00,34229,950,0,4712,28567,28973,-406
8/29/2016 5:00,34514,451,0,4712,29350,31378,-2028
8/29/2016 6:00,36416,400,0,4712,31304,32460,-1156
8/29/2016 7:00,39647,630,95,4712,34210,33001,1209
8/29/2016 8:00,40448,567,297,4712,34872,35135,-263
8/29/2016 9:00,41465,714,422,4712,35617,37637,-2020
8/29/2016 10:00,43694,1087,483,4712,37412,40434,-3022
8/29/2016 11:00,46505,1736,507,4712,39549,41819,-2270
8/29/2016 12:00,49409,2274,505,4712,41918,42805,-887
8/29/2016 13:00,51604,2747,503,4712,43642,42502,1140
8/29/2016 14:00,53245,2679,431,4712,45424,42094,3330
8/29/2016 15:00,53420,2989,350,4712,45369,41922,3447
8/29/2016 16:00,53155,2721,366,4712,45356,41917,3439
8/29/2016 17:00,53528,3175,259,4712,45381,40761,4620
8/29/2016 18:00,53308,2572,210,4712,45814,39465,6349
8/29/2016 19:00,51943,2483,3,4712,44745,39295,5450
8/29/2016 20:00,50303,2512,0,4712,43078,37198,5880
8/29/2016 21:00,50194,2614,0,4712,42867,34222,8645
8/29/2016 22:00,48134,2096,0,4712,41326,31152,10174
8/29/2016 23:00,44390,1623,0,4712,38054,29106,8948
8/30/2016 0:00,40504,1195,0,4712,34597,28130,6467
8/30/2016 1:00,37654,997,0,4712,31946,27198,4748
8/30/2016 2:00,35838,847,0,4712,30279,26786,3493
8/30/2016 3:00,34598,935,0,4712,28951,26799,2152
8/30/2016 4:00,33940,900,0,4712,28328,28181,147
8/30/2016 5:00,34122,850,0,4712,28559,30495,-1936
8/30/2016 6:00,35918,971,0,4712,30235,31697,-1462
8/30/2016 7:00,39186,922,70,4712,33481,32535,946
8/30/2016 8:00,40102,675,296,4712,34419,34633,-214
8/30/2016 9:00,41200,825,394,4712,35268,37375,-2107
8/30/2016 10:00,43633,1170,431,4712,37321,40603,-3282
8/30/2016 11:00,46718,1360,504,4712,40142,43110,-2968
8/30/2016 12:00,49933,1650,502,4712,43068,44861,-1793
8/30/2016 13:00,53101,2224,503,4712,45662,45708,-46
8/30/2016 14:00,55519,2248,496,4712,48062,46635,1427
8/30/2016 15:00,57091,2400,478,4712,49501,46330,3171
8/30/2016 16:00,57760,2258,439,4712,50351,46091,4260
8/30/2016 17:00,57915,2130,367,4712,50707,44790,5917
8/30/2016 18:00,57088,1982,307,4712,50087,43241,6846
8/30/2016 19:00,55334,1996,38,4712,48588,42093,6495
8/30/2016 20:00,53523,2224,0,4712,46587,39479,7108
8/30/2016 21:00,52899,1976,0,4712,46210,35708,10502
8/30/2016 22:00,50110,1601,0,4712,43797,32228,11569
8/30/2016 23:00,46016,1346,0,4712,39958,29828,10130
8/31/2016 0:00,41979,990,0,4712,36277,28119,8158
8/31/2016 1:00,38834,987,0,4712,33135,27003,6132
8/31/2016 2:00,36788,1059,0,4712,31016,26878,4138
8/31/2016 3:00,35496,929,0,4712,29855,27016,2839
8/31/2016 4:00,34766,1020,0,4712,29034,28406,628
8/31/2016 5:00,34868,880,0,4712,29276,31628,-2352
8/31/2016 6:00,36650,922,0,4712,31016,32681,-1665
8/31/2016 7:00,39934,720,64,4712,34438,34197,241
8/31/2016 8:00,40662,465,235,4712,35250,37556,-2306
8/31/2016 9:00,42102,536,308,4712,36546,41697,-5151
8/31/2016 10:00,45225,195,378,4712,39940,45538,-5598
8/31/2016 11:00,49106,134,498,4712,43763,48439,-4676
8/31/2016 12:00,52897,381,509,4712,47296,50516,-3220
8/31/2016 13:00,55992,723,509,4712,50049,50496,-447
8/31/2016 14:00,58759,968,504,4712,52576,51228,1348
8/31/2016 15:00,60590,1094,484,4712,54300,50808,3492
8/31/2016 16:00,61638,1436,445,4712,55045,50348,4697
8/31/2016 17:00,61756,1488,422,4712,55133,48634,6499
8/31/2016 18:00,60791,1588,290,4712,54201,46137,8064
8/31/2016 19:00,58844,2106,11,4712,52015,44728,7287
8/31/2016 20:00,56464,2670,0,4712,49082,41493,7589
8/31/2016 21:00,55377,2684,0,4712,47982,37902,10080
8/31/2016 22:00,52385,1827,0,4712,45845,34191,11654
8/31/2016 23:00,48127,1333,0,4712,42081,30923,11158
9/1/2016 0:00,43729,1143,0,4712,37873,29018,8855
9/1/2016 1:00,40335,853,0,4712,34770,27727,7043
9/1/2016 2:00,38111,824,0,4712,32575,27220,5355
9/1/2016 3:00,36465,550,0,4712,31203,27231,3972
9/1/2016 4:00,35537,726,0,4712,30099,28321,1778
9/1/2016 5:00,35567,821,0,4712,30034,30950,-916
9/1/2016 6:00,37234,825,0,4712,31697,31579,118
9/1/2016 7:00,40320,883,97,4712,34628,33016,1612
9/1/2016 8:00,40901,687,202,4712,35299,36540,-1241
9/1/2016 9:00,42370,626,305,4712,36727,40445,-3718
9/1/2016 10:00,45666,600,443,4712,39911,43632,-3721
9/1/2016 11:00,49474,582,480,4712,43699,46162,-2463
9/1/2016 12:00,52870,768,499,4712,46892,47365,-473
9/1/2016 13:00,55536,1202,501,4712,49120,48412,708
9/1/2016 14:00,57664,1071,495,4712,51385,49441,1944
9/1/2016 15:00,59338,1396,478,4712,52753,49371,3382
9/1/2016 16:00,60181,1475,439,4712,53555,48416,5139
9/1/2016 17:00,60306,1397,367,4712,53830,46821,7009
9/1/2016 18:00,59049,1905,239,4712,52194,43829,8365
9/1/2016 19:00,56653,2484,20,4712,49437,42521,6916
9/1/2016 20:00,54316,2177,0,4712,47427,40874,6553
9/1/2016 21:00,53415,1332,0,4712,47371,37376,9995
9/1/2016 22:00,50742,1149,0,4712,44881,33299,11582
9/1/2016 23:00,46752,799,0,4712,41241,30660,10581
9/2/2016 0:00,42698,758,0,4712,37228,28793,8435
9/2/2016 1:00,39602,665,0,4712,34225,27450,6775
9/2/2016 2:00,37368,542,0,4712,32114,27049,5065
9/2/2016 3:00,35846,453,0,4712,30681,27276,3405
9/2/2016 4:00,35036,409,0,4712,29915,28638,1277
9/2/2016 5:00,35074,324,0,4712,30038,31142,-1104
9/2/2016 6:00,36713,391,0,4712,31610,31568,42
9/2/2016 7:00,39745,432,49,4712,34551,32751,1800
9/2/2016 8:00,40393,301,185,4712,35195,35565,-370
9/2/2016 9:00,41565,229,324,4712,36300,38885,-2585
9/2/2016 10:00,44140,204,466,4712,38758,41887,-3129
9/2/2016 11:00,47207,246,481,4712,41768,44416,-2648
9/2/2016 12:00,50297,361,456,4712,44767,46347,-1580
9/2/2016 13:00,53281,486,502,4712,47581,47370,211
9/2/2016 14:00,55842,791,483,4712,49856,47606,2250
9/2/2016 15:00,57290,965,438,4712,51175,47214,3961
9/2/2016 16:00,57659,1105,415,4712,51426,46064,5362
9/2/2016 17:00,57415,1850,339,4712,50514,43459,7055
9/2/2016 18:00,55993,2149,252,4712,48880,40657,8223
9/2/2016 19:00,53561,2347,7,4712,46495,38992,7503
9/2/2016 20:00,51190,3452,0,4712,43026,35970,7056
9/2/2016 21:00,50168,4204,0,4712,41252,32255,8997
9/2/2016 22:00,47901,4893,0,4712,38296,29267,9029
9/2/2016 23:00,44886,4925,0,4712,35249,26766,8483
9/3/2016 0:00,41671,4693,0,4712,32266,25401,6865
9/3/2016 1:00,38621,4258,0,4712,29651,24263,5388
9/3/2016 2:00,36418,4266,0,4712,27439,23371,4068
9/3/2016 3:00,34843,3965,0,4712,26166,22949,3217
9/3/2016 4:00,33730,3832,0,4712,25186,23147,2039
9/3/2016 5:00,33091,3634,0,4712,24745,23889,856
9/3/2016 6:00,33172,3476,0,4712,24984,24742,242
9/3/2016 7:00,33755,3131,108,4712,25805,27279,-1474
9/3/2016 8:00,34093,2554,241,4712,26586,29803,-3217
9/3/2016 9:00,36480,3147,337,4712,28284,32577,-4293
9/3/2016 10:00,39924,2958,360,4712,31895,35816,-3921
9/3/2016 11:00,43513,2761,460,4712,35580,38556,-2976
9/3/2016 12:00,47005,2851,470,4712,38972,41163,-2191
9/3/2016 13:00,50130,3028,488,4712,41902,42590,-688
9/3/2016 14:00,52623,3380,498,4712,44033,43023,1010
9/3/2016 15:00,54319,4262,483,4712,44863,42950,1913
9/3/2016 16:00,55316,4878,401,4712,45326,42423,2903
9/3/2016 17:00,55719,4716,372,4712,45919,40573,5346
9/3/2016 18:00,55271,4818,243,4712,45498,37722,7776
9/3/2016 19:00,53498,5285,0,4712,43501,35889,7612
9/3/2016 20:00,51079,6488,0,4712,39879,32726,7153
9/3/2016 21:00,49897,7856,0,4712,37330,29574,7756
9/3/2016 22:00,47555,8367,0,4712,34475,26499,7976
9/3/2016 23:00,44569,8373,0,4712,31484,24352,7132
9/4/2016 0:00,41411,8012,0,4712,28688,21940,6748
9/4/2016 1:00,38489,8265,0,4712,25513,20161,5352
9/4/2016 2:00,36271,8460,0,4712,23100,19352,3748
9/4/2016 3:00,34687,7856,0,4712,22119,19350,2769
9/4/2016 4:00,33579,7256,0,4712,21611,19560,2051
9/4/2016 5:00,32871,7084,0,4712,21075,19864,1211
9/4/2016 6:00,32718,7259,0,4712,20747,20318,429
9/4/2016 7:00,32990,7038,22,4712,21218,22959,-1741
9/4/2016 8:00,33146,7151,211,4712,21072,25872,-4800
9/4/2016 9:00,35635,8022,292,4712,22609,28817,-6208
9/4/2016 10:00,39486,8022,394,4712,26358,32040,-5682
9/4/2016 11:00,43430,7922,487,4712,30309,35156,-4847
9/4/2016 12:00,47164,7859,499,4712,34094,36680,-2586
9/4/2016 13:00,50449,9026,497,4712,36215,36961,-746
9/4/2016 14:00,52927,9542,487,4712,38187,37565,622
9/4/2016 15:00,54413,9159,480,4712,40062,38227,1835
9/4/2016 16:00,55147,9239,444,4712,40752,37968,2784
9/4/2016 17:00,55460,9065,324,4712,41359,36672,4687
9/4/2016 18:00,54914,8138,238,4712,41827,35001,6826
9/4/2016 19:00,52881,7336,0,4712,40833,33477,7356
9/4/2016 20:00,50525,9061,0,4712,36752,30476,6276
9/4/2016 21:00,49426,9975,0,4712,34740,27518,7222
9/4/2016 22:00,47349,10649,0,4712,31988,24849,7139
9/4/2016 23:00,44594,10348,0,4712,29535,23106,6429
9/5/2016 0:00,41683,9409,0,4712,27561,21414,6147
9/5/2016 1:00,38943,9460,0,4712,24771,20298,4473
9/5/2016 2:00,36919,9319,0,4712,22887,19575,3312
9/5/2016 3:00,35634,9489,0,4712,21433,19017,2416
9/5/2016 4:00,34827,9771,0,4712,20343,19761,582
9/5/2016 5:00,34567,8620,0,4712,21236,21386,-150
9/5/2016 6:00,34991,8292,0,4712,21987,21992,-5
9/5/2016 7:00,35723,7827,59,4712,23125,24599,-1474
9/5/2016 8:00,35755,8245,284,4712,22514,26851,-4337
9/5/2016 9:00,38005,10140,384,4712,22769,29133,-6364
9/5/2016 10:00,42091,11284,462,4712,25633,31873,-6240
9/5/2016 11:00,46346,11923,472,4712,29238,33744,-4506
9/5/2016 12:00,49870,12341,493,4712,32324,34699,-2375
9/5/2016 13:00,52707,12666,492,4712,34837,35305,-468
9/5/2016 14:00,54799,12924,488,4712,36675,36282,393
9/5/2016 15:00,55929,12745,430,4712,38042,36806,1236
9/5/2016 16:00,56709,12793,362,4712,38841,37101,1740
9/5/2016 17:00,57221,12694,374,4712,39440,36266,3174
9/5/2016 18:00,57182,11626,255,4712,40588,35900,4688
9/5/2016 19:00,55960,9829,0,4712,41418,35704,5714
9/5/2016 20:00,54187,10075,0,4712,39400,33197,6203
9/5/2016 21:00,53682,10741,0,4712,38229,28921,9308
9/5/2016 22:00,51163,11648,0,4712,34803,25442,9361
9/5/2016 23:00,47054,11698,0,4712,30644,22770,7874
9/6/2016 0:00,43059,11463,0,4712,26884,21130,5754
9/6/2016 1:00,39917,11138,0,4712,24067,20186,3881
9/6/2016 2:00,37953,10699,0,4712,22542,20083,2459
9/6/2016 3:00,36743,10005,0,4712,22026,21099,927
9/6/2016 4:00,36154,9434,0,4712,22009,23628,-1619
9/6/2016 5:00,36399,8703,0,4712,22984,26586,-3602
9/6/2016 6:00,38295,8290,0,4712,25293,27284,-1991
9/6/2016 7:00,41480,8093,100,4712,28576,28825,-249
9/6/2016 8:00,42360,8432,230,4712,28987,30362,-1375
9/6/2016 9:00,43612,11215,306,4712,27379,32050,-4671
9/6/2016 10:00,46444,11526,463,4712,29744,35201,-5457
9/6/2016 11:00,49749,11213,491,4712,33333,38052,-4719
9/6/2016 12:00,53082,10708,493,4712,37169,40075,-2906
9/6/2016 13:00,56147,10849,497,4712,40090,41674,-1584
9/6/2016 14:00,58889,10939,489,4712,42749,42307,442
9/6/2016 15:00,60749,10665,440,4712,44932,42338,2594
9/6/2016 16:00,61820,10786,425,4712,45897,41973,3924
9/6/2016 17:00,62253,11119,342,4712,46080,39791,6289
9/6/2016 18:00,61710,11416,194,4712,45388,38583,6805
9/6/2016 19:00,59875,10215,1,4712,44946,38683,6263
9/6/2016 20:00,57596,9529,0,4712,43355,36583,6772
9/6/2016 21:00,56555,9007,0,4712,42836,32390,10446
9/6/2016 22:00,53575,9204,0,4712,39659,28802,10857
9/6/2016 23:00,49313,8726,0,4712,35876,26460,9416
9/7/2016 0:00,45112,9141,0,4712,31259,24492,6767
9/7/2016 1:00,41842,9313,0,4712,27817,23430,4387
9/7/2016 2:00,39723,8942,0,4712,26069,22896,3173
9/7/2016 3:00,38359,8848,0,4712,24799,22462,2337
9/7/2016 4:00,37572,9342,0,4712,23518,24091,-573
9/7/2016 5:00,37631,9274,0,4712,23645,26549,-2904
9/7/2016 6:00,39305,9426,0,4712,25167,27250,-2083
9/7/2016 7:00,42506,9197,70,4712,28528,29001,-473
9/7/2016 8:00,43238,9276,284,4712,28967,30655,-1688
9/7/2016 9:00,44498,10620,363,4712,28803,33426,-4623
9/7/2016 10:00,47705,9979,409,4712,32605,37077,-4472
9/7/2016 11:00,51365,8685,489,4712,37479,41506,-4027
9/7/2016 12:00,54671,7057,499,4712,42403,44970,-2567
9/7/2016 13:00,57714,6329,497,4712,46176,46410,-234
9/7/2016 14:00,60469,6612,495,4712,48650,46060,2590
9/7/2016 15:00,61918,6687,476,4712,50042,46061,3981
9/7/2016 16:00,61946,6696,438,4712,50100,45485,4615
9/7/2016 17:00,61856,7389,364,4712,49391,44741,4650
9/7/2016 18:00,61482,6920,231,4712,49619,42932,6687
9/7/2016 19:00,60043,7271,0,4712,48060,41080,6980
9/7/2016 20:00,57798,8454,0,4712,44632,38056,6576
9/7/2016 21:00,56925,8392,0,4712,43821,34025,9796
9/7/2016 22:00,54123,8346,0,4712,41065,29851,11214
9/7/2016 23:00,49842,8007,0,4712,37124,27432,9692
9/8/2016 0:00,45650,8506,0,4712,32432,25458,6974
9/8/2016 1:00,42414,8354,0,4712,29347,24699,4648
9/8/2016 2:00,40249,8173,0,4712,27363,23960,3403
9/8/2016 3:00,38750,8072,0,4712,25965,24082,1883
9/8/2016 4:00,37888,7733,0,4712,25443,26025,-582
9/8/2016 5:00,38021,7271,0,4712,26038,28581,-2543
9/8/2016 6:00,39734,7129,0,4712,27894,29183,-1289
9/8/2016 7:00,42809,6830,73,4712,31195,31109,86
9/8/2016 8:00,43276,5864,266,4712,32434,32568,-134
9/8/2016 9:00,44582,6989,359,4712,32523,35613,-3090
9/8/2016 10:00,47545,6216,440,4712,36176,39728,-3552
9/8/2016 11:00,50868,5375,477,4712,40304,44304,-4000
9/8/2016 12:00,54344,4718,495,4712,44420,47006,-2586
9/8/2016 13:00,57611,4890,495,4712,47514,47978,-464
9/8/2016 14:00,60634,5431,484,4712,50008,48117,1891
9/8/2016 15:00,62702,6131,456,4712,51403,47809,3594
9/8/2016 16:00,63244,6805,414,4712,51313,47098,4215
9/8/2016 17:00,63251,7327,378,4712,50834,45505,5329
9/8/2016 18:00,62432,6875,258,4712,50587,43698,6889
9/8/2016 19:00,60599,6713,0,4712,49174,41981,7193
9/8/2016 20:00,58113,8130,0,4712,45271,38158,7113
9/8/2016 21:00,56873,8697,0,4712,43464,33151,10313
9/8/2016 22:00,54003,9201,0,4712,40090,28619,11471
9/8/2016 23:00,49662,9476,0,4712,35474,26056,9418
9/9/2016 0:00,45343,9156,0,4712,31475,24122,7353
9/9/2016 1:00,41915,8750,0,4712,28453,22832,5621
9/9/2016 2:00,39562,8849,0,4712,26001,22349,3652
9/9/2016 3:00,38048,8435,0,4712,24901,22844,2057
9/9/2016 4:00,37216,7804,0,4712,24700,24763,-63
9/9/2016 5:00,37240,7852,0,4712,24676,26650,-1974
9/9/2016 6:00,38804,8070,0,4712,26022,27098,-1076
9/9/2016 7:00,41719,7694,9,4712,29305,29295,10
9/9/2016 8:00,42274,6514,115,4712,30933,31678,-745
9/9/2016 9:00,43756,6975,325,4712,31744,35154,-3410
9/9/2016 10:00,47023,6354,374,4712,35583,38735,-3152
9/9/2016 11:00,50490,5799,388,4712,39590,41906,-2316
9/9/2016 12:00,53698,5554,423,4712,43009,44210,-1201
9/9/2016 13:00,56355,5468,388,4712,45787,45331,456
9/9/2016 14:00,58749,5903,371,4712,47763,45524,2239
9/9/2016 15:00,60091,6165,396,4712,48817,45724,3093
9/9/2016 16:00,60666,6107,339,4712,49507,45073,4434
9/9/2016 17:00,60844,6500,264,4712,49368,42960,6408
9/9/2016 18:00,59909,6498,163,4712,48535,40471,8064
9/9/2016 19:00,57645,6907,0,4712,46027,38235,7792
9/9/2016 20:00,55064,8372,0,4712,41979,34049,7930
9/9/2016 21:00,53726,9841,0,4712,39173,30116,9057
9/9/2016 22:00,51339,10387,0,4712,36241,27305,8936
9/9/2016 23:00,48232,8849,0,4712,34671,25448,9223
9/10/2016 0:00,44871,7932,0,4712,32227,23838,8389
9/10/2016 1:00,41708,8407,0,4712,28589,22789,5800
9/10/2016 2:00,39484,7809,0,4712,26963,22257,4706
9/10/2016 3:00,37688,7858,0,4712,25119,21245,3874
9/10/2016 4:00,36407,8502,0,4712,23193,20421,2772
9/10/2016 5:00,35583,8944,0,4712,21927,20690,1237
9/10/2016 6:00,35269,9160,0,4712,21397,21140,257
9/10/2016 7:00,35755,8480,16,4712,22547,24315,-1768
9/10/2016 8:00,36110,5802,208,4712,25389,27047,-1658
9/10/2016 9:00,37767,6499,307,4712,26248,28902,-2654
9/10/2016 10:00,40486,5350,383,4712,30041,32270,-2229
9/10/2016 11:00,43053,3690,380,4712,34270,34678,-408
9/10/2016 12:00,45088,2744,448,4712,37184,35870,1314
9/10/2016 13:00,46604,2963,454,4712,38476,36826,1650
9/10/2016 14:00,47725,2247,427,4712,40340,38108,2232
9/10/2016 15:00,48402,1692,405,4712,41593,39108,2485
9/10/2016 16:00,49057,1737,338,4712,42271,39619,2652
9/10/2016 17:00,49527,1654,253,4712,42909,38691,4218
9/10/2016 18:00,49488,1286,94,4712,43396,37530,5866
9/10/2016 19:00,48392,904,0,4712,42776,36844,5932
9/10/2016 20:00,46698,1074,0,4712,40911,34420,6491
9/10/2016 21:00,45967,1663,0,4712,39592,30789,8803
9/10/2016 22:00,44035,2335,0,4712,36988,27549,9439
9/10/2016 23:00,41478,2519,0,4712,34248,25203,9045
9/11/2016 0:00,38582,2635,0,4712,31235,23614,7621
9/11/2016 1:00,35839,2694,0,4712,28432,22462,5970
9/11/2016 2:00,33744,2548,0,4712,26484,21819,4665
9/11/2016 3:00,32196,2545,0,4712,24939,21196,3743
9/11/2016 4:00,31147,2595,0,4712,23840,21025,2815
9/11/2016 5:00,30462,2733,0,4712,23017,21148,1869
9/11/2016 6:00,30338,2920,0,4712,22706,21213,1493
9/11/2016 7:00,30694,2956,3,4712,23023,22765,258
9/11/2016 8:00,30841,2713,69,4712,23347,25656,-2309
9/11/2016 9:00,33126,3083,179,4712,25152,28052,-2900
9/11/2016 10:00,36510,3457,293,4712,28048,31239,-3191
9/11/2016 11:00,40005,3661,275,4712,31357,34084,-2727
9/11/2016 12:00,43608,3764,396,4712,34736,36933,-2197
9/11/2016 13:00,47007,3558,323,4712,38414,39374,-960
9/11/2016 14:00,49994,3642,257,4712,41384,40874,510
9/11/2016 15:00,52323,3455,245,4712,43911,41736,2175
9/11/2016 16:00,54005,3576,252,4712,45466,41734,3732
9/11/2016 17:00,55005,3940,138,4712,46216,40397,5819
9/11/2016 18:00,55037,4251,61,4712,46012,38677,7335
9/11/2016 19:00,53712,5504,0,4712,43496,35790,7706
9/11/2016 20:00,51854,7127,0,4712,40015,31430,8585
9/11/2016 21:00,50773,8297,0,4712,37764,27180,10584
9/11/2016 22:00,47944,8953,0,4712,34279,23781,10498
9/11/2016 23:00,43966,9423,0,4712,29831,21113,8718
9/12/2016 0:00,39966,9489,0,4712,25765,19115,6650
9/12/2016 1:00,36922,9366,0,4712,22844,17950,4894
9/12/2016 2:00,34814,8889,0,4712,21213,17614,3599
9/12/2016 3:00,33492,8810,0,4712,19970,18108,1862
9/12/2016 4:00,32800,8684,0,4712,19404,19884,-480
9/12/2016 5:00,32966,8499,0,4712,19756,23187,-3431
9/12/2016 6:00,34730,8116,0,4712,21902,24198,-2296
9/12/2016 7:00,37854,7632,99,4712,25411,25846,-435
9/12/2016 8:00,38640,6476,362,4712,27090,28602,-1512
9/12/2016 9:00,40008,6743,449,4712,28104,32118,-4014
9/12/2016 10:00,43126,6726,446,4712,31242,35392,-4150
9/12/2016 11:00,46712,5603,473,4712,35924,39045,-3121
9/12/2016 12:00,50034,4863,489,4712,39969,42276,-2307
9/12/2016 13:00,52988,4638,489,4712,43149,44748,-1599
9/12/2016 14:00,55920,4528,479,4712,46201,45736,465
9/12/2016 15:00,57919,4606,470,4712,48131,45622,2509
9/12/2016 16:00,59224,4898,434,4712,49180,45179,4001
9/12/2016 17:00,59880,5072,359,4712,49737,42912,6825
9/12/2016 18:00,59012,6098,221,4712,47981,40271,7710
9/12/2016 19:00,56982,6791,0,4712,45479,38485,6994
9/12/2016 20:00,54824,7823,0,4712,42290,34210,8080
9/12/2016 21:00,53730,8970,0,4712,40048,29504,10544
9/12/2016 22:00,50686,9002,0,4712,36972,26587,10385
9/12/2016 23:00,46406,7949,0,4712,33744,24368,9376
9/13/2016 0:00,42244,7465,0,4712,30067,23174,6893
9/13/2016 1:00,39076,6795,0,4712,27569,22759,4810
9/13/2016 2:00,36967,6007,0,4712,26248,22777,3471
9/13/2016 3:00,35524,5712,0,4712,25099,23114,1985
9/13/2016 4:00,34865,5261,0,4712,24892,24941,-49
9/13/2016 5:00,35061,4866,0,4712,25483,28038,-2555
9/13/2016 6:00,36829,4142,0,4712,27975,28882,-907
9/13/2016 7:00,39887,3666,67,4712,31441,30313,1128
9/13/2016 8:00,40479,2889,328,4712,32550,32599,-49
9/13/2016 9:00,41498,3592,447,4712,32747,35328,-2581
9/13/2016 10:00,43934,3039,477,4712,35706,38933,-3227
9/13/2016 11:00,47086,2500,480,4712,39394,42204,-2810
9/13/2016 12:00,50392,2076,495,4712,43109,44711,-1602
9/13/2016 13:00,53402,1910,495,4712,46285,45677,608
9/13/2016 14:00,56063,2431,487,4712,48434,45781,2653
9/13/2016 15:00,57604,2724,409,4712,49758,45651,4107
9/13/2016 16:00,58258,2914,403,4712,50230,45486,4744
9/13/2016 17:00,58164,2425,332,4712,50694,44108,6586
9/13/2016 18:00,57204,2967,196,4712,49329,42539,6790
9/13/2016 19:00,55329,3624,0,4712,46993,41390,5603
9/13/2016 20:00,54054,3597,0,4712,45745,39238,6507
9/13/2016 21:00,53277,3151,0,4712,45414,35259,10155
9/13/2016 22:00,50605,2897,0,4712,42996,31467,11529
9/13/2016 23:00,46606,2618,0,4712,39276,28931,10345
9/14/2016 0:00,42679,2009,0,4712,35958,27722,8236
9/14/2016 1:00,39591,1794,0,4712,33085,26769,6316
9/14/2016 2:00,37565,1734,0,4712,31118,26651,4467
9/14/2016 3:00,36161,1303,0,4712,30147,26908,3239
9/14/2016 4:00,35448,1103,0,4712,29634,28370,1264
9/14/2016 5:00,35575,1118,0,4712,29744,31325,-1581
9/14/2016 6:00,37424,851,0,4712,31861,32384,-523
9/14/2016 7:00,40483,752,106,4712,34913,33884,1029
9/14/2016 8:00,41218,391,378,4712,35738,36795,-1057
9/14/2016 9:00,42417,336,418,4712,36951,39972,-3021
9/14/2016 10:00,45446,279,458,4712,39998,43019,-3021
9/14/2016 11:00,48903,449,486,4712,43256,45162,-1906
9/14/2016 12:00,52086,578,492,4712,46305,46302,3
9/14/2016 13:00,54725,1150,491,4712,48372,46943,1429
9/14/2016 14:00,57061,1663,495,4712,50190,47745,2445
9/14/2016 15:00,58438,2066,481,4712,51179,47119,4060
9/14/2016 16:00,59185,2678,441,4712,51354,46540,4814
9/14/2016 17:00,59341,2597,361,4712,51671,44442,7229
9/14/2016 18:00,58262,3214,223,4712,50113,43152,6961
9/14/2016 19:00,56345,2721,0,4712,48912,41985,6927
9/14/2016 20:00,54547,3510,0,4712,46326,39001,7325
9/14/2016 21:00,53429,3374,0,4712,45344,34604,10740
9/14/2016 22:00,50502,3728,0,4712,42062,30258,11804
9/14/2016 23:00,46417,4031,0,4712,37674,27553,10121
9/15/2016 0:00,42305,4075,0,4712,33518,26214,7304
9/15/2016 1:00,39234,4213,0,4712,30309,24909,5400
9/15/2016 2:00,37087,4650,0,4712,27725,24402,3323
9/15/2016 3:00,35651,4127,0,4712,26813,25019,1794
9/15/2016 4:00,34955,3486,0,4712,26756,26910,-154
9/15/2016 5:00,34933,2817,0,4712,27404,29526,-2122
9/15/2016 6:00,36580,2667,0,4712,29201,30184,-983
9/15/2016 7:00,39823,2207,64,4712,32839,32036,803
9/15/2016 8:00,40445,1368,233,4712,34132,35436,-1304
9/15/2016 9:00,41854,1462,275,4712,35405,39285,-3880
9/15/2016 10:00,45229,990,299,4712,39228,42913,-3685
9/15/2016 11:00,49001,903,425,4712,42961,45436,-2475
9/15/2016 12:00,52254,905,486,4712,46151,47663,-1512
9/15/2016 13:00,55144,1180,489,4712,48763,49281,-518
9/15/2016 14:00,57777,1360,467,4712,51238,49752,1486
9/15/2016 15:00,59635,2098,463,4712,52362,49265,3097
9/15/2016 16:00,60724,2450,426,4712,53137,48399,4738
9/15/2016 17:00,61417,3051,344,4712,53311,45840,7471
9/15/2016 18:00,60390,3412,173,4712,52093,43512,8581
9/15/2016 19:00,57866,4860,0,4712,48295,41223,7072
9/15/2016 20:00,56030,5654,0,4712,45664,37199,8465
9/15/2016 21:00,54996,6520,0,4712,43764,32787,10977
9/15/2016 22:00,52010,7097,0,4712,40201,28879,11322
9/15/2016 23:00,47954,7603,0,4712,35639,26311,9328
9/16/2016 0:00,43860,6078,0,4712,33070,25342,7728
9/16/2016 1:00,40571,5225,0,4712,30634,24855,5779
9/16/2016 2:00,38368,4894,0,4712,28762,24479,4283
9/16/2016 3:00,36818,4119,0,4712,27987,25476,2511
9/16/2016 4:00,35971,2986,0,4712,28273,27764,509
9/16/2016 5:00,36003,2494,0,4712,28797,29942,-1145
9/16/2016 6:00,37540,2502,0,4712,30326,30529,-203
9/16/2016 7:00,40593,2619,23,4712,33239,31486,1753
9/16/2016 8:00,41439,2558,227,4712,33941,33936,5
9/16/2016 9:00,42494,2398,301,4712,35083,36160,-1077
9/16/2016 10:00,44998,4530,347,4712,35409,37545,-2136
9/16/2016 11:00,48287,4916,465,4712,38194,41099,-2905
9/16/2016 12:00,51735,3754,489,4712,42780,45550,-2770
9/16/2016 13:00,54976,2234,486,4712,47543,47759,-216
9/16/2016 14:00,57636,1990,450,4712,50484,48768,1716
9/16/2016 15:00,59789,1932,401,4712,52743,49297,3446
9/16/2016 16:00,61207,2000,390,4712,54104,48004,6100
9/16/2016 17:00,61736,3695,280,4712,53049,44008,9041
9/16/2016 18:00,60668,6161,197,4712,49598,41746,7852
9/16/2016 19:00,57990,4842,0,4712,48437,41402,7035
9/16/2016 20:00,55458,4328,0,4712,46418,38230,8188
9/16/2016 21:00,53662,4538,0,4712,44412,35319,9093
9/16/2016 22:00,50633,4180,0,4712,41741,31362,10379
9/16/2016 23:00,47281,4777,0,4712,37793,28104,9689
9/17/2016 0:00,43874,5300,0,4712,33862,26177,7685
9/17/2016 1:00,40968,5534,0,4712,30722,25390,5332
9/17/2016 2:00,38602,5005,0,4712,28885,24894,3991
9/17/2016 3:00,37034,4068,0,4712,28253,24993,3260
9/17/2016 4:00,35852,3081,0,4712,28059,25276,2783
9/17/2016 5:00,35189,2896,0,4712,27581,26109,1472
9/17/2016 6:00,35307,2676,0,4712,27918,26918,1000
9/17/2016 7:00,36015,2082,43,4712,29178,29680,-502
9/17/2016 8:00,36543,1016,180,4712,30635,33736,-3101
9/17/2016 9:00,39076,1170,258,4712,32936,37952,-5016
9/17/2016 10:00,43340,885,352,4712,37391,41738,-4347
9/17/2016 11:00,47751,985,476,4712,41578,44162,-2584
9/17/2016 12:00,51643,975,484,4712,45471,46773,-1302
9/17/2016 13:00,55035,735,485,4712,49104,48107,997
9/17/2016 14:00,57675,1100,483,4712,51380,48883,2497
9/17/2016 15:00,59357,1359,451,4712,52835,49043,3792
9/17/2016 16:00,60589,2067,353,4712,53457,48342,5115
9/17/2016 17:00,61115,3119,356,4712,52927,46277,6650
9/17/2016 18:00,60667,3618,218,4712,52119,43332,8787
9/17/2016 19:00,58511,4252,0,4712,49547,40941,8606
9/17/2016 20:00,55985,5230,0,4712,46043,37481,8562
9/17/2016 21:00,54002,5152,0,4712,44138,34247,9891
9/17/2016 22:00,51143,6305,0,4712,40125,29516,10609
9/17/2016 23:00,47731,7519,0,4712,35500,26767,8733
9/18/2016 0:00,44459,7540,0,4712,32206,25475,6731
9/18/2016 1:00,41466,6498,0,4712,30256,25303,4953
9/18/2016 2:00,39115,5416,0,4712,28986,24600,4386
9/18/2016 3:00,37380,5296,0,4712,27372,23382,3990
9/18/2016 4:00,36148,6238,0,4712,25197,23388,1809
9/18/2016 5:00,35537,5754,0,4712,25071,24186,885
9/18/2016 6:00,35525,4830,0,4712,25984,25205,779
9/18/2016 7:00,35740,3611,11,4712,27405,27902,-497
9/18/2016 8:00,35656,2495,195,4712,28254,31148,-2894
9/18/2016 9:00,37749,2075,272,4712,30690,34612,-3922
9/18/2016 10:00,41515,2284,363,4712,34156,38522,-4366
9/18/2016 11:00,45326,1563,473,4712,38578,42692,-4114
9/18/2016 12:00,49413,1195,474,4712,43031,46592,-3561
9/18/2016 13:00,53386,1047,478,4712,47149,48512,-1363
9/18/2016 14:00,56865,1428,482,4712,50243,49639,604
9/18/2016 15:00,59557,1591,453,4712,52801,50221,2580
9/18/2016 16:00,61322,1745,399,4712,54465,50453,4012
9/18/2016 17:00,62193,1970,291,4712,55220,49208,6012
9/18/2016 18:00,62274,2371,212,4712,54980,46887,8093
9/18/2016 19:00,60661,3599,0,4712,52349,44419,7930
9/18/2016 20:00,58749,4850,0,4712,49187,40255,8932
9/18/2016 21:00,57206,5912,0,4712,46582,35518,11064
9/18/2016 22:00,54198,6672,0,4712,42814,30421,12393
9/18/2016 23:00,50088,7270,0,4712,38106,27655,10451
9/19/2016 0:00,45880,7139,0,4712,34029,25897,8132
9/19/2016 1:00,42530,7261,0,4712,30557,24455,6102
9/19/2016 2:00,40155,7167,0,4712,28276,23841,4435
9/19/2016 3:00,38583,7116,0,4712,26755,24243,2512
9/19/2016 4:00,37817,6915,0,4712,26190,26384,-194
9/19/2016 5:00,37930,6938,0,4712,26280,28710,-2430
9/19/2016 6:00,39583,6589,0,4712,28281,29754,-1473
9/19/2016 7:00,42510,5947,17,4712,31834,32095,-261
9/19/2016 8:00,43180,3941,201,4712,34325,37201,-2876
9/19/2016 9:00,44704,2900,275,4712,36817,42164,-5347
9/19/2016 10:00,48364,2204,392,4712,41055,46739,-5684
9/19/2016 11:00,52696,1435,465,4712,46084,50394,-4310
9/19/2016 12:00,56830,1291,400,4712,50427,52698,-2271
9/19/2016 13:00,60618,1574,454,4712,53878,54123,-245
9/19/2016 14:00,63950,1847,403,4712,56989,54634,2355
9/19/2016 15:00,66026,2154,337,4712,58822,54806,4016
9/19/2016 16:00,66830,2304,303,4712,59511,54735,4776
9/19/2016 17:00,66852,2331,191,4712,59618,53531,6087
9/19/2016 18:00,66151,2910,85,4712,58444,50671,7773
9/19/2016 19:00,64061,4235,0,4712,55114,47264,7850
9/19/2016 20:00,61947,5695,0,4712,51540,42030,9510
9/19/2016 21:00,60249,6811,0,4712,48726,36759,11967
9/19/2016 22:00,56611,7722,0,4712,44177,32447,11730
9/19/2016 23:00,51916,8108,0,4712,39096,29161,9935
9/20/2016 0:00,47355,7982,0,4712,34661,27383,7278
9/20/2016 1:00,43853,7775,0,4712,31366,26526,4840
9/20/2016 2:00,41367,7161,0,4712,29494,25935,3559
9/20/2016 3:00,39658,6702,0,4712,28245,26092,2153
9/20/2016 4:00,38536,6113,0,4712,27712,27959,-247
9/20/2016 5:00,38238,5958,0,4712,27568,30661,-3093
9/20/2016 6:00,39673,5447,0,4712,29514,31549,-2035
9/20/2016 7:00,42650,4673,30,4712,33234,33456,-222
9/20/2016 8:00,43222,3160,142,4712,35208,37197,-1989
9/20/2016 9:00,44532,2891,254,4712,36676,41958,-5282
9/20/2016 10:00,47886,2380,416,4712,40377,46634,-6257
9/20/2016 11:00,52008,1685,403,4712,45208,49525,-4317
9/20/2016 12:00,56088,1788,433,4712,49154,51594,-2440
9/20/2016 13:00,59625,2352,484,4712,52077,53254,-1177
9/20/2016 14:00,62438,2693,407,4712,54627,53478,1149
9/20/2016 15:00,64258,2849,357,4712,56340,53876,2464
9/20/2016 16:00,65255,2930,317,4712,57295,52596,4699
9/20/2016 17:00,65663,3199,210,4712,57542,50086,7456
9/20/2016 18:00,64317,3438,126,4712,56041,47651,8390
9/20/2016 19:00,61622,4603,0,4712,52307,44340,7967
9/20/2016 20:00,59525,6286,0,4712,48526,39484,9042
9/20/2016 21:00,57704,7579,0,4712,45413,33994,11419
9/20/2016 22:00,54375,8601,0,4712,41062,29929,11133
9/20/2016 23:00,49903,9253,0,4712,35938,26648,9290
9/21/2016 0:00,45393,9068,0,4712,31613,24916,6697
9/21/2016 1:00,41933,8654,0,4712,28567,23962,4605
9/21/2016 2:00,39609,7860,0,4712,27038,23594,3444
9/21/2016 3:00,37842,7214,0,4712,25916,24190,1726
9/21/2016 4:00,36708,6303,0,4712,25693,26195,-502
9/21/2016 5:00,36567,5478,0,4712,26376,29121,-2745
9/21/2016 6:00,38019,5009,0,4712,28298,30133,-1835
9/21/2016 7:00,40944,4338,84,4712,31810,31788,22
9/21/2016 8:00,41350,3074,284,4712,33280,35129,-1849
9/21/2016 9:00,42343,2677,388,4712,34566,38448,-3882
9/21/2016 10:00,45287,2882,421,4712,37273,41643,-4370
9/21/2016 11:00,48921,2996,414,4712,40798,44760,-3962
9/21/2016 12:00,52515,2912,452,4712,44439,47900,-3461
9/21/2016 13:00,55765,2865,472,4712,47717,49881,-2164
9/21/2016 14:00,58682,3280,400,4712,50291,50162,129
9/21/2016 15:00,60810,3604,242,4712,52252,50286,1966
9/21/2016 16:00,62052,3928,227,4712,53185,49282,3903
9/21/2016 17:00,62449,3858,191,4712,53688,47072,6616
9/21/2016 18:00,61392,3911,81,4712,52689,44940,7749
9/21/2016 19:00,58786,4607,0,4712,49467,42590,6877
9/21/2016 20:00,56677,5361,0,4712,46604,38102,8502
9/21/2016 21:00,54863,6491,0,4712,43660,32750,10910
9/21/2016 22:00,51507,7792,0,4712,39004,28697,10307
9/21/2016 23:00,47068,8512,0,4712,33843,24685,9158
9/22/2016 0:00,42837,8854,0,4712,29272,22952,6320
9/22/2016 1:00,39527,8385,0,4712,26430,21945,4485
9/22/2016 2:00,37388,8085,0,4712,24591,21238,3353
9/22/2016 3:00,35789,7739,0,4712,23337,21751,1586
9/22/2016 4:00,34867,7022,0,4712,23132,23608,-476
9/22/2016 5:00,34894,6614,0,4712,23568,26067,-2499
9/22/2016 6:00,36423,6337,0,4712,25374,26923,-1549
9/22/2016 7:00,39502,5847,66,4712,28877,29064,-187
9/22/2016 8:00,40231,4236,203,4712,31081,32974,-1893
9/22/2016 9:00,41325,4853,314,4712,31445,35531,-4086
9/22/2016 10:00,44294,4885,321,4712,34377,39512,-5135
9/22/2016 11:00,48127,3657,335,4712,39423,43188,-3765
9/22/2016 12:00,51723,3052,343,4712,43616,46419,-2803
9/22/2016 13:00,54879,2536,345,4712,47287,48443,-1156
9/22/2016 14:00,57641,2869,403,4712,49657,49052,605
9/22/2016 15:00,59749,3296,435,4712,51306,48766,2540
9/22/2016 16:00,61076,3802,389,4712,52173,47654,4519
9/22/2016 17:00,61611,4185,331,4712,52383,45300,7083
9/22/2016 18:00,60431,4683,184,4712,50852,43114,7738
9/22/2016 19:00,57921,5990,0,4712,47219,40169,7050
9/22/2016 20:00,56046,7278,0,4712,44056,36283,7773
9/22/2016 21:00,54724,8254,0,4712,41758,32045,9713
9/22/2016 22:00,51798,9280,0,4712,37806,27666,10140
9/22/2016 23:00,47722,9588,0,4712,33422,24703,8719
9/23/2016 0:00,43717,9192,0,4712,29812,23584,6228
9/23/2016 1:00,40553,8896,0,4712,26945,22671,4274
9/23/2016 2:00,38436,8620,0,4712,25104,22494,2610
9/23/2016 3:00,37059,8089,0,4712,24258,22959,1299
9/23/2016 4:00,36217,7372,0,4712,24133,24588,-455
9/23/2016 5:00,36283,7173,0,4712,24398,27448,-3050
9/23/2016 6:00,37929,6945,0,4712,26272,28639,-2367
9/23/2016 7:00,41046,6404,42,4712,29888,30380,-492
9/23/2016 8:00,41885,5417,225,4712,31531,32888,-1357
9/23/2016 9:00,43018,6617,361,4712,31327,33867,-2540
9/23/2016 10:00,45939,7982,434,4712,32811,35763,-2952
9/23/2016 11:00,49043,8021,463,4712,35847,37763,-1916
9/23/2016 12:00,51864,8281,477,4712,38394,39777,-1383
9/23/2016 13:00,54202,8696,427,4712,40366,41444,-1078
9/23/2016 14:00,56752,9083,372,4712,42585,42231,354
9/23/2016 15:00,58677,9329,343,4712,44292,41848,2444
9/23/2016 16:00,59689,9794,297,4712,44886,41159,3727
9/23/2016 17:00,60057,10016,313,4712,45016,39151,5865
9/23/2016 18:00,59050,9525,152,4712,44661,37930,6731
9/23/2016 19:00,56665,9273,0,4712,42680,36391,6289
9/23/2016 20:00,54568,10208,0,4712,39648,33248,6400
9/23/2016 21:00,53338,10642,0,4712,37983,30449,7534
9/23/2016 22:00,51017,11249,0,4712,35056,27314,7742
9/23/2016 23:00,48111,11700,0,4712,31698,24361,7337
9/24/2016 0:00,45126,11495,0,4712,28920,23012,5908
9/24/2016 1:00,42170,10648,0,4712,26810,22354,4456
9/24/2016 2:00,39914,10380,0,4712,24822,22010,2812
9/24/2016 3:00,38216,9861,0,4712,23643,21986,1657
9/24/2016 4:00,37132,9574,0,4712,22846,22396,450
9/24/2016 5:00,36624,9049,0,4712,22862,23416,-554
9/24/2016 6:00,36827,8784,0,4712,23331,24604,-1273
9/24/2016 7:00,37758,7894,49,4712,25104,27028,-1924
9/24/2016 8:00,38529,7686,220,4712,25911,28492,-2581
9/24/2016 9:00,40534,9287,379,4712,26156,30684,-4528
9/24/2016 10:00,43699,9535,427,4712,29025,34252,-5227
9/24/2016 11:00,46821,8210,471,4712,33428,38236,-4808
9/24/2016 12:00,49838,7128,342,4712,37656,39925,-2269
9/24/2016 13:00,52597,6780,417,4712,40688,40577,111
9/24/2016 14:00,54217,6741,415,4712,42349,39975,2374
9/24/2016 15:00,54670,6814,454,4712,42690,39470,3220
9/24/2016 16:00,54201,6506,411,4712,42572,39786,2786
9/24/2016 17:00,53329,6444,321,4712,41852,39065,2787
9/24/2016 18:00,52852,6326,141,4712,41673,37290,4383
9/24/2016 19:00,51666,6845,0,4712,40109,36205,3904
9/24/2016 20:00,50639,6762,0,4712,39166,33824,5342
9/24/2016 21:00,49421,5357,0,4712,39352,32333,7019
9/24/2016 22:00,47114,4179,0,4712,38223,30157,8066
9/24/2016 23:00,44420,4721,0,4712,34987,28197,6790
9/25/2016 0:00,41651,3395,0,4712,33545,27625,5920
9/25/2016 1:00,39131,2793,0,4712,31626,26979,4647
9/25/2016 2:00,37179,2704,0,4712,29762,25752,4010
9/25/2016 3:00,35789,2921,0,4712,28156,24794,3362
9/25/2016 4:00,34897,2633,0,4712,27553,24744,2809
9/25/2016 5:00,34400,3271,0,4712,26417,25249,1168
9/25/2016 6:00,34423,2483,0,4712,27228,25806,1422
9/25/2016 7:00,34861,3198,64,4712,26886,26062,824
9/25/2016 8:00,35267,4359,323,4712,25872,27750,-1878
9/25/2016 9:00,36740,4503,351,4712,27174,29002,-1828
9/25/2016 10:00,39062,5289,438,4712,28623,30568,-1945
9/25/2016 11:00,41146,5624,476,4712,30334,32463,-2129
9/25/2016 12:00,43062,5529,485,4712,32336,33500,-1164
9/25/2016 13:00,45146,6424,458,4712,33552,33319,233
9/25/2016 14:00,46535,6822,470,4712,34531,31718,2813
9/25/2016 15:00,46716,7854,456,4712,33694,30012,3682
9/25/2016 16:00,45853,9450,405,4712,31286,28162,3124
9/25/2016 17:00,45044,10658,310,4712,29363,27955,1408
9/25/2016 18:00,44463,9432,125,4712,30195,29222,973
9/25/2016 19:00,43798,8753,0,4712,30332,29811,521
9/25/2016 20:00,44350,7676,0,4712,31962,29243,2719
9/25/2016 21:00,43992,6401,0,4712,32879,27660,5219
9/25/2016 22:00,42426,6434,0,4712,31279,24347,6932
9/25/2016 23:00,39793,6206,0,4712,28874,22405,6469
9/26/2016 0:00,36856,5706,0,4712,26438,21536,4902
9/26/2016 1:00,34399,5639,0,4712,24048,20595,3453
9/26/2016 2:00,32848,6335,0,4712,21801,20148,1653
9/26/2016 3:00,31949,6739,0,4712,20498,19810,688
9/26/2016 4:00,31627,8078,0,4712,18836,21162,-2326
9/26/2016 5:00,32036,7536,0,4712,19788,24101,-4313
9/26/2016 6:00,33826,7354,0,4712,21760,25283,-3523
9/26/2016 7:00,36914,6399,47,4712,25757,26524,-767
9/26/2016 8:00,37961,5203,334,4712,27712,28116,-404
9/26/2016 9:00,38176,5413,422,4712,27629,28879,-1250
9/26/2016 10:00,39279,6042,461,4712,28064,29904,-1840
9/26/2016 11:00,40771,6582,488,4712,28989,30398,-1409
9/26/2016 12:00,42088,6965,494,4712,29917,31102,-1185
9/26/2016 13:00,43186,6703,491,4712,31279,31494,-215
9/26/2016 14:00,44032,6317,486,4712,32517,32170,347
9/26/2016 15:00,44242,5303,457,4712,33770,32365,1405
9/26/2016 16:00,44194,4520,405,4712,34557,32784,1773
9/26/2016 17:00,43756,3317,293,4712,35434,32722,2712
9/26/2016 18:00,42917,2393,180,4712,35631,33816,1815
9/26/2016 19:00,42177,2320,0,4712,35145,33148,1997
9/26/2016 20:00,42654,2661,0,4712,35281,31407,3874
9/26/2016 21:00,42152,2329,0,4712,35111,29085,6026
9/26/2016 22:00,40362,1859,0,4712,33791,26292,7499
9/26/2016 23:00,37668,1945,0,4712,31010,24265,6745
9/27/2016 0:00,34499,2011,0,4712,27776,22986,4790
9/27/2016 1:00,32258,2348,0,4712,25199,22153,3046
9/27/2016 2:00,30952,2578,0,4712,23662,21780,1882
9/27/2016 3:00,30114,2556,0,4712,22846,22381,465
9/27/2016 4:00,29847,2230,0,4712,22905,24116,-1211
9/27/2016 5:00,30290,2085,0,4712,23493,26934,-3441
9/27/2016 6:00,32030,2178,0,4712,25140,27678,-2538
9/27/2016 7:00,35243,2210,70,4712,28250,27716,534
9/27/2016 8:00,36203,1991,312,4712,29188,29161,27
9/27/2016 9:00,36367,1114,392,4712,30149,30709,-560
9/27/2016 10:00,37435,834,450,4712,31438,31899,-461
9/27/2016 11:00,38775,647,482,4712,32934,33573,-639
9/27/2016 12:00,40108,648,473,4712,34275,35421,-1146
9/27/2016 13:00,41558,635,434,4712,35776,36257,-481
9/27/2016 14:00,43242,524,443,4712,37563,36685,878
9/27/2016 15:00,44264,597,382,4712,38573,36615,1958
9/27/2016 16:00,44688,667,313,4712,38995,36176,2819
9/27/2016 17:00,44766,662,228,4712,39165,35564,3601
9/27/2016 18:00,44238,663,157,4712,38707,35373,3334
9/27/2016 19:00,43358,1168,0,4712,37478,34542,2936
9/27/2016 20:00,43375,1783,0,4712,36880,31540,5340
9/27/2016 21:00,42952,2456,0,4712,35784,27752,8032
9/27/2016 22:00,40676,3082,0,4712,32882,24672,8210
9/27/2016 23:00,37326,3323,0,4712,29291,22364,6927
9/28/2016 0:00,33923,3685,0,4712,25526,20958,4568
9/28/2016 1:00,31486,3902,0,4712,22871,19759,3112
9/28/2016 2:00,29990,4231,0,4712,21048,19348,1700
9/28/2016 3:00,28948,3807,0,4712,20429,20220,209
9/28/2016 4:00,28448,3438,0,4712,20298,22018,-1720
9/28/2016 5:00,28820,3304,0,4712,20803,24741,-3938
9/28/2016 6:00,30555,2832,0,4712,23011,25968,-2957
9/28/2016 7:00,33775,2525,47,4712,26491,26567,-76
9/28/2016 8:00,34643,1972,266,4712,27693,29281,-1588
9/28/2016 9:00,35246,729,337,4712,29468,31668,-2200
9/28/2016 10:00,37117,453,401,4712,31551,33523,-1972
9/28/2016 11:00,39253,278,409,4712,33855,35731,-1876
9/28/2016 12:00,41509,481,407,4712,35909,38406,-2497
9/28/2016 13:00,43833,430,457,4712,38233,40798,-2565
9/28/2016 14:00,46416,358,425,4712,40921,42653,-1732
9/28/2016 15:00,48794,573,383,4712,43126,43601,-475
9/28/2016 16:00,50949,506,314,4712,45417,43708,1709
9/28/2016 17:00,52511,509,256,4712,47034,42521,4513
9/28/2016 18:00,52571,594,153,4712,47112,40784,6328
9/28/2016 19:00,50765,1042,0,4712,45010,38636,6374
9/28/2016 20:00,48919,1707,0,4712,42500,34878,7622
9/28/2016 21:00,47412,2152,0,4712,40548,30843,9705
9/28/2016 22:00,44344,2504,0,4712,37128,27389,9739
9/28/2016 23:00,40461,2949,0,4712,32800,24828,7972
9/29/2016 0:00,36571,2802,0,4712,29057,23208,5849
9/29/2016 1:00,33599,2917,0,4712,25970,21988,3982
9/29/2016 2:00,31638,3578,0,4712,23348,20716,2632
9/29/2016 3:00,30380,4184,0,4712,21484,20426,1058
9/29/2016 4:00,29645,4515,0,4712,20418,21827,-1409
9/29/2016 5:00,29730,4272,0,4712,20746,24637,-3891
9/29/2016 6:00,31203,4398,0,4712,22093,25099,-3006
9/29/2016 7:00,34221,4198,53,4712,25258,26255,-997
9/29/2016 8:00,34924,2712,355,4712,27145,28557,-1412
9/29/2016 9:00,35575,2429,404,4712,28031,29865,-1834
9/29/2016 10:00,37288,2606,456,4712,29514,31442,-1928
9/29/2016 11:00,39302,2234,466,4712,31890,33887,-1997
9/29/2016 12:00,41101,2022,485,4712,33882,35953,-2071
9/29/2016 13:00,43257,1868,482,4712,36194,37427,-1233
9/29/2016 14:00,45347,1861,472,4712,38302,38473,-171
9/29/2016 15:00,47009,1615,457,4712,40225,38748,1477
9/29/2016 16:00,48116,1351,409,4712,41644,38506,3138
9/29/2016 17:00,48601,1085,308,4712,42495,36641,5854
9/29/2016 18:00,47867,1234,112,4712,41809,35285,6524
9/29/2016 19:00,45775,1922,0,4712,39141,33368,5773
9/29/2016 20:00,44437,2744,0,4712,36981,30417,6564
9/29/2016 21:00,43397,3033,0,4712,35652,27029,8623
9/29/2016 22:00,40725,3190,0,4712,32822,23766,9056
9/29/2016 23:00,37177,3509,0,4712,28956,21457,7499
9/30/2016 0:00,33496,3658,0,4712,25126,19994,5132
9/30/2016 1:00,30799,3717,0,4712,22370,19002,3368
9/30/2016 2:00,29111,3696,0,4712,20703,18758,1945
9/30/2016 3:00,27991,3416,0,4712,19863,19111,752
9/30/2016 4:00,27490,3464,0,4712,19313,20707,-1394
9/30/2016 5:00,27718,3393,0,4712,19614,22669,-3055
9/30/2016 6:00,29344,3467,0,4712,21165,23513,-2348
9/30/2016 7:00,32267,3374,74,4712,24107,24272,-165
9/30/2016 8:00,33145,2158,312,4712,25963,26306,-343
9/30/2016 9:00,33739,1912,408,4712,26706,27653,-947
9/30/2016 10:00,35247,1779,454,4712,28302,29158,-856
9/30/2016 11:00,36820,1441,478,4712,30189,30460,-271
9/30/2016 12:00,38333,1586,485,4712,31550,31996,-446
9/30/2016 13:00,39814,1625,486,4712,32991,33496,-505
9/30/2016 14:00,41658,1726,476,4712,34744,34629,115
9/30/2016 15:00,43321,1871,443,4712,36295,35712,583
9/30/2016 16:00,44691,2077,421,4712,37481,35279,2202
9/30/2016 17:00,45615,2065,325,4712,38512,32920,5592
9/30/2016 18:00,45165,2509,136,4712,37807,30889,6918
9/30/2016 19:00,43113,2919,0,4712,35482,29541,5941
9/30/2016 20:00,41517,3817,0,4712,32988,26572,6416
9/30/2016 21:00,40335,4279,0,4712,31343,24167,7176
9/30/2016 22:00,38190,4472,0,4712,29005,21922,7083
9/30/2016 23:00,35691,4839,0,4712,26140,19882,6258
10/1/2016 0:00,32967,5121,0,4712,23135,18263,4872
10/1/2016 1:00,30660,5210,0,4712,20738,17405,3333
10/1/2016 2:00,28996,4976,0,4712,19307,17116,2191
10/1/2016 3:00,27946,4385,0,4712,18849,17204,1645
10/1/2016 4:00,27335,3964,0,4712,18659,17697,962
10/1/2016 5:00,27123,4118,0,4712,18293,18659,-366
10/1/2016 6:00,27515,3947,0,4712,18856,19612,-756
10/1/2016 7:00,28510,3758,63,4712,19977,21270,-1293
10/1/2016 8:00,29223,3001,353,4712,21157,23705,-2548
10/1/2016 9:00,30684,2654,396,4712,22922,24958,-2036
10/1/2016 10:00,32801,3234,445,4712,24410,26108,-1698
10/1/2016 11:00,34901,3236,455,4712,26498,27649,-1151
10/1/2016 12:00,36686,2936,455,4712,28584,29333,-749
10/1/2016 13:00,38365,2701,484,4712,30468,30491,-23
10/1/2016 14:00,40034,2694,478,4712,32150,31053,1097
10/1/2016 15:00,41470,2769,450,4712,33540,31184,2356
10/1/2016 16:00,42394,2867,397,4712,34418,30865,3553
10/1/2016 17:00,42698,2942,291,4712,34754,29743,5011
10/1/2016 18:00,42293,3554,148,4712,33878,28681,5197
10/1/2016 19:00,41112,5193,0,4712,31207,26254,4953
10/1/2016 20:00,40694,7174,0,4712,28808,23101,5707
10/1/2016 21:00,40048,7913,0,4712,27423,20738,6685
10/1/2016 22:00,38346,8678,0,4712,24956,18716,6240
10/1/2016 23:00,36085,8670,0,4712,22703,17092,5611
10/2/2016 0:00,33643,8448,0,4712,20483,16004,4479
10/2/2016 1:00,31359,7694,0,4712,18952,15502,3450
10/2/2016 2:00,29636,7306,0,4712,17618,14953,2665
10/2/2016 3:00,28414,7225,0,4712,16476,15299,1177
10/2/2016 4:00,27704,6427,0,4712,16566,15924,642
10/2/2016 5:00,27353,5810,0,4712,16831,16766,65
10/2/2016 6:00,27438,5480,0,4712,17245,17530,-285
10/2/2016 7:00,27930,4926,66,4712,18226,19544,-1318
10/2/2016 8:00,28342,3668,291,4712,19671,22284,-2613
10/2/2016 9:00,29897,2821,396,4712,21968,24707,-2739
10/2/2016 10:00,32331,2495,444,4712,24681,26830,-2149
10/2/2016 11:00,34769,2775,469,4712,26813,28782,-1969
10/2/2016 12:00,37187,3212,478,4712,28785,30683,-1898
10/2/2016 13:00,39684,3583,474,4712,30916,32207,-1291
10/2/2016 14:00,42305,3891,466,4712,33237,33581,-344
10/2/2016 15:00,44534,4076,431,4712,35315,34240,1075
10/2/2016 16:00,46304,4385,360,4712,36848,33928,2920
10/2/2016 17:00,47335,4894,239,4712,37489,32524,4965
10/2/2016 18:00,47333,5090,47,4712,37484,31332,6152
10/2/2016 19:00,45872,6429,0,4712,34731,28867,5864
10/2/2016 20:00,45097,7846,0,4712,32539,25383,7156
10/2/2016 21:00,44139,8748,0,4712,30679,21697,8982
10/2/2016 22:00,41692,9593,0,4712,27387,18925,8462
10/2/2016 23:00,38268,9935,0,4712,23621,16684,6937
10/3/2016 0:00,34781,9790,0,4712,20280,15291,4989
10/3/2016 1:00,32260,9538,0,4712,18009,14630,3379
10/3/2016 2:00,30568,9176,0,4712,16680,14720,1960
10/3/2016 3:00,29542,8857,0,4712,15974,15179,795
10/3/2016 4:00,29021,8710,0,4712,15599,16969,-1370
10/3/2016 5:00,29290,8734,0,4712,15844,19569,-3725
10/3/2016 6:00,31011,8808,0,4712,17492,20255,-2763
10/3/2016 7:00,34122,8748,27,4712,20636,21541,-905
10/3/2016 8:00,35092,7209,216,4712,22955,23788,-833
10/3/2016 9:00,35725,7077,298,4712,23639,25399,-1760
10/3/2016 10:00,37850,7188,318,4712,25632,28113,-2481
10/3/2016 11:00,40492,6569,279,4712,28932,30167,-1235
10/3/2016 12:00,43051,7191,337,4712,30811,31920,-1109
10/3/2016 13:00,45391,7823,300,4712,32556,32955,-399
10/3/2016 14:00,47858,8588,349,4712,34209,33845,364
10/3/2016 15:00,49921,9318,269,4712,35622,33904,1718
10/3/2016 16:00,51510,10000,203,4712,36595,32988,3607
10/3/2016 17:00,52360,10571,125,4712,36952,31262,5690
10/3/2016 18:00,51847,10427,42,4712,36666,29795,6871
10/3/2016 19:00,49872,11743,0,4712,33416,27865,5551
10/3/2016 20:00,48801,12596,0,4712,31493,24919,6574
10/3/2016 21:00,47507,12579,0,4712,30216,21632,8584
10/3/2016 22:00,44678,12557,0,4712,27410,18607,8803
10/3/2016 23:00,40813,12139,0,4712,23962,16488,7474
10/4/2016 0:00,36964,12178,0,4712,20074,15121,4953
10/4/2016 1:00,34201,11933,0,4712,17556,14277,3279
10/4/2016 2:00,32475,11935,0,4712,15828,13977,1851
10/4/2016 3:00,31372,11459,0,4712,15201,14619,582
10/4/2016 4:00,30820,11250,0,4712,14858,16569,-1711
10/4/2016 5:00,31154,10811,0,4712,15631,19422,-3791
10/4/2016 6:00,32888,10476,0,4712,17700,20767,-3067
10/4/2016 7:00,36179,9968,47,4712,21452,22077,-625
10/4/2016 8:00,37364,8490,137,4712,24025,24787,-762
10/4/2016 9:00,37936,8198,164,4712,24862,27154,-2292
10/4/2016 10:00,40138,7685,209,4712,27532,29652,-2120
10/4/2016 11:00,42896,7386,236,4712,30563,32438,-1875
10/4/2016 12:00,45749,6955,234,4712,33848,35132,-1284
10/4/2016 13:00,48506,7075,227,4712,36492,37048,-556
10/4/2016 14:00,51217,7087,194,4712,39223,38677,546
10/4/2016 15:00,53288,6994,149,4712,41433,39515,1918
10/4/2016 16:00,54877,7307,125,4712,42733,39332,3401
10/4/2016 17:00,55768,6851,90,4712,44115,38500,5615
10/4/2016 18:00,55097,5547,0,4712,44838,37911,6927
10/4/2016 19:00,53006,5987,0,4712,42306,35986,6320
10/4/2016 20:00,51991,6814,0,4712,40465,33212,7253
10/4/2016 21:00,50788,7751,0,4712,38325,28782,9543
10/4/2016 22:00,48255,8845,0,4712,34697,24952,9745
10/4/2016 23:00,44648,8740,0,4712,31196,23002,8194
10/5/2016 0:00,40816,7983,0,4712,28121,22249,5872
10/5/2016 1:00,37895,7137,0,4712,26046,21754,4292
10/5/2016 2:00,36040,6593,0,4712,24736,21260,3476
10/5/2016 3:00,34774,6531,0,4712,23531,21769,1762
10/5/2016 4:00,34099,6210,0,4712,23177,23771,-594
10/5/2016 5:00,34283,5836,0,4712,23735,27141,-3406
10/5/2016 6:00,36111,5210,0,4712,26189,28848,-2659
10/5/2016 7:00,39465,4498,26,4712,30229,30278,-49
10/5/2016 8:00,40556,2967,81,4712,32797,33214,-417
10/5/2016 9:00,40917,2441,225,4712,33539,36172,-2633
10/5/2016 10:00,43229,2400,188,4712,35929,39257,-3328
10/5/2016 11:00,46214,2062,308,4712,39133,42068,-2935
10/5/2016 12:00,49345,1655,348,4712,42630,44550,-1920
10/5/2016 13:00,52328,1830,418,4712,45368,45937,-569
10/5/2016 14:00,55282,2680,434,4712,47457,46740,717
10/5/2016 15:00,57738,3476,363,4712,49187,46727,2460
10/5/2016 16:00,59359,4353,351,4712,49942,45350,4592
10/5/2016 17:00,59848,4939,255,4712,49942,42686,7256
10/5/2016 18:00,58698,5587,82,4712,48318,40253,8065
10/5/2016 19:00,56222,7321,0,4712,44189,37525,6664
10/5/2016 20:00,54741,8278,0,4712,41751,33772,7979
10/5/2016 21:00,53119,8936,0,4712,39471,29181,10290
10/5/2016 22:00,50018,9189,0,4712,36117,25612,10505
10/5/2016 23:00,46156,9886,0,4712,31558,23007,8551
10/6/2016 0:00,42213,10313,0,4712,27188,21163,6025
10/6/2016 1:00,39288,10295,0,4712,24281,20019,4262
10/6/2016 2:00,37404,10556,0,4712,22136,19546,2590
10/6/2016 3:00,36112,10414,0,4712,20986,19848,1138
10/6/2016 4:00,35431,10183,0,4712,20536,21509,-973
10/6/2016 5:00,35586,10154,0,4712,20719,24497,-3778
10/6/2016 6:00,37347,9873,0,4712,22763,25870,-3107
10/6/2016 7:00,40819,9399,22,4712,26686,27029,-343
10/6/2016 8:00,41908,8021,291,4712,28885,29463,-578
10/6/2016 9:00,42239,8778,402,4712,28347,31083,-2736
10/6/2016 10:00,44219,8668,421,4712,30418,34008,-3590
10/6/2016 11:00,46906,7384,455,4712,34355,37719,-3364
10/6/2016 12:00,49555,5979,473,4712,38392,41022,-2630
10/6/2016 13:00,52089,5084,435,4712,41858,43196,-1338
10/6/2016 14:00,54497,4333,434,4712,45018,45285,-267
10/6/2016 15:00,56036,3843,332,4712,47149,45356,1793
10/6/2016 16:00,57090,4464,293,4712,47621,43881,3740
10/6/2016 17:00,57328,5501,130,4712,46986,41651,5335
10/6/2016 18:00,56423,5637,24,4712,46050,40036,6014
10/6/2016 19:00,54308,6867,0,4712,42730,37418,5312
10/6/2016 20:00,53413,8095,0,4712,40606,33454,7152
10/6/2016 21:00,52026,9157,0,4712,38157,28845,9312
10/6/2016 22:00,49186,9597,0,4712,34877,25430,9447
10/6/2016 23:00,45363,8782,0,4712,31868,23024,8844
10/7/2016 0:00,41383,8627,0,4712,28044,21712,6332
10/7/2016 1:00,38303,8422,0,4712,25170,20585,4585
10/7/2016 2:00,36161,8671,0,4712,22778,19373,3405
10/7/2016 3:00,34761,9774,0,4712,20276,18466,1810
10/7/2016 4:00,33986,10594,0,4712,18679,19842,-1163
10/7/2016 5:00,33987,10322,0,4712,18953,22765,-3812
10/7/2016 6:00,35407,10353,0,4712,20342,23409,-3067
10/7/2016 7:00,38266,10360,19,4712,23175,24053,-878
10/7/2016 8:00,39275,9463,119,4712,24981,26330,-1349
10/7/2016 9:00,39721,8637,255,4712,26118,29070,-2952
10/7/2016 10:00,41383,6328,280,4712,30063,31877,-1814
10/7/2016 11:00,43067,4789,312,4712,33254,33677,-423
10/7/2016 12:00,44297,3914,358,4712,35313,34897,416
10/7/2016 13:00,45271,3555,421,4712,36583,35545,1038
10/7/2016 14:00,46364,3401,360,4712,37891,35771,2120
10/7/2016 15:00,46915,3825,233,4712,38145,35335,2810
10/7/2016 16:00,47065,4152,181,4712,38020,34191,3829
10/7/2016 17:00,47031,3778,140,4712,38401,32661,5740
10/7/2016 18:00,45964,3030,29,4712,38192,32814,5378
10/7/2016 19:00,43765,2945,0,4712,36107,31297,4810
10/7/2016 20:00,42997,3425,0,4712,34860,29218,5642
10/7/2016 21:00,41890,3628,0,4712,33551,27045,6506
10/7/2016 22:00,40073,3632,0,4712,31729,24837,6892
10/7/2016 23:00,37833,3595,0,4712,29526,23231,6295
10/8/2016 0:00,35282,2813,0,4712,27757,22395,5362
10/8/2016 1:00,32807,2298,0,4712,25797,21364,4433
10/8/2016 2:00,31014,2396,0,4712,23905,20909,2996
10/8/2016 3:00,29648,2334,0,4712,22601,20594,2007
10/8/2016 4:00,28851,2562,0,4712,21577,20698,879
10/8/2016 5:00,28484,2849,0,4712,20923,21266,-343
10/8/2016 6:00,28746,3096,0,4712,20937,21901,-964
10/8/2016 7:00,29648,2873,3,4712,22061,23316,-1255
10/8/2016 8:00,30367,2348,93,4712,23214,25766,-2552
10/8/2016 9:00,31683,1760,124,4712,25087,27651,-2564
10/8/2016 10:00,33759,1693,221,4712,27132,29284,-2152
10/8/2016 11:00,35553,1138,273,4712,29430,31209,-1779
10/8/2016 12:00,37285,1250,253,4712,31070,32395,-1325
10/8/2016 13:00,38998,1331,252,4712,32703,33561,-858
10/8/2016 14:00,40765,1323,309,4712,34422,34469,-47
10/8/2016 15:00,42358,1482,316,4712,35848,34950,898
10/8/2016 16:00,43569,1297,214,4712,37346,34302,3044
10/8/2016 17:00,44212,1820,174,4712,37506,32729,4777
10/8/2016 18:00,43749,1538,101,4712,37398,32022,5376
10/8/2016 19:00,42104,1980,0,4712,35412,31141,4271
10/8/2016 20:00,41463,1962,0,4712,34789,29491,5298
10/8/2016 21:00,40356,2382,0,4712,33262,27134,6128
10/8/2016 22:00,38481,2437,0,4712,31332,24736,6596
10/8/2016 23:00,36268,2343,0,4712,29213,23065,6148
10/9/2016 0:00,33778,2291,0,4712,26775,21436,5339
10/9/2016 1:00,31502,2284,0,4712,24505,20845,3660
10/9/2016 2:00,29646,2145,0,4712,22789,20382,2407
10/9/2016 3:00,28340,2053,0,4712,21575,20170,1405
10/9/2016 4:00,27504,2251,0,4712,20541,19891,650
10/9/2016 5:00,27001,2468,0,4712,19821,20043,-222
10/9/2016 6:00,26930,2938,0,4712,19280,20195,-915
10/9/2016 7:00,27407,3390,1,4712,19304,21490,-2186
10/9/2016 8:00,27857,2396,101,4712,20648,23501,-2853
10/9/2016 9:00,29262,1722,194,4712,22635,24726,-2091
10/9/2016 10:00,31198,2369,268,4712,23849,25584,-1735
10/9/2016 11:00,32800,2646,358,4712,25084,26773,-1689
10/9/2016 12:00,34254,2699,373,4712,26471,27984,-1513
10/9/2016 13:00,35761,2482,366,4712,28201,28888,-687
10/9/2016 14:00,37237,2710,339,4712,29476,29701,-225
10/9/2016 15:00,38576,2920,348,4712,30596,30123,473
10/9/2016 16:00,39740,2941,324,4712,31763,30027,1736
10/9/2016 17:00,40332,3171,204,4712,32245,28892,3353
10/9/2016 18:00,39825,3584,35,4712,31494,28423,3071
10/9/2016 19:00,38891,5087,0,4712,29092,26117,2975
10/9/2016 20:00,39286,6276,0,4712,28298,23355,4943
10/9/2016 21:00,38142,7111,0,4712,26319,21027,5292
10/9/2016 22:00,36322,7759,0,4712,23851,18307,5544
10/9/2016 23:00,34087,7910,0,4712,21465,16337,5128
10/10/2016 0:00,31125,7848,0,4712,18565,14936,3629
10/10/2016 1:00,28949,7777,0,4712,16461,14378,2083
10/10/2016 2:00,27576,8127,0,4712,14737,13985,752
10/10/2016 3:00,26820,8198,0,4712,13910,14554,-644
10/10/2016 4:00,26632,8168,0,4712,13751,16067,-2316
10/10/2016 5:00,26999,7826,0,4712,14461,18283,-3822
10/10/2016 6:00,28498,8147,0,4712,15639,18993,-3354
10/10/2016 7:00,30961,8135,9,4712,18104,20266,-2162
10/10/2016 8:00,32185,6615,232,4712,20626,22724,-2098
10/10/2016 9:00,32770,5566,350,4712,22141,24461,-2320
10/10/2016 10:00,34260,5455,423,4712,23670,26249,-2579
10/10/2016 11:00,35930,4427,422,4712,26369,28528,-2159
10/10/2016 12:00,37483,3575,469,4712,28727,30530,-1803
10/10/2016 13:00,39135,3034,466,4712,30923,31917,-994
10/10/2016 14:00,40980,3034,459,4712,32775,33356,-581
10/10/2016 15:00,42728,2932,418,4712,34666,34354,312
10/10/2016 16:00,44287,2819,347,4712,36409,34416,1993
10/10/2016 17:00,45325,3092,285,4712,37237,32902,4335
10/10/2016 18:00,45272,3852,58,4712,36650,30612,6038
10/10/2016 19:00,43908,7476,0,4712,31720,27119,4601
10/10/2016 20:00,43375,9682,0,4712,28981,23563,5418
10/10/2016 21:00,42211,10758,0,4712,26741,19912,6829
10/10/2016 22:00,39738,11187,0,4712,23838,16911,6927
10/10/2016 23:00,36310,11214,0,4712,20384,15101,5283
10/11/2016 0:00,33036,10645,0,4712,17680,14153,3527
10/11/2016 1:00,30639,10194,0,4712,15733,13351,2382
10/11/2016 2:00,29205,9747,0,4712,14746,13457,1289
10/11/2016 3:00,28319,9650,0,4712,13956,14188,-232
10/11/2016 4:00,27982,9482,0,4712,13788,16387,-2599
10/11/2016 5:00,28415,9252,0,4712,14451,19766,-5315
10/11/2016 6:00,30305,8771,0,4712,16822,20905,-4083
10/11/2016 7:00,33656,8440,37,4712,20468,21646,-1178
10/11/2016 8:00,34781,6824,326,4712,22918,24260,-1342
10/11/2016 9:00,34873,4836,408,4712,24917,27017,-2100
10/11/2016 10:00,36153,3613,428,4712,27400,29298,-1898
10/11/2016 11:00,38032,3023,457,4712,29840,31668,-1828
10/11/2016 12:00,40145,2744,473,4712,32216,33551,-1335
10/11/2016 13:00,42262,3082,469,4712,33998,34441,-443
10/11/2016 14:00,44456,3455,466,4712,35824,35093,731
10/11/2016 15:00,45945,3820,437,4712,36977,35971,1006
10/11/2016 16:00,47315,4166,377,4712,38059,35453,2606
10/11/2016 17:00,48458,4782,277,4712,38686,34003,4683
10/11/2016 18:00,48386,5726,32,4712,37916,31761,6155
10/11/2016 19:00,47028,8631,0,4712,33685,28575,5110
10/11/2016 20:00,46782,10481,0,4712,31589,25407,6182
10/11/2016 21:00,45757,11220,0,4712,29825,22423,7402
10/11/2016 22:00,43393,11092,0,4712,27589,19906,7683
10/11/2016 23:00,40033,10795,0,4712,24526,18432,6094
10/12/2016 0:00,36573,10755,0,4712,21106,17427,3679
10/12/2016 1:00,33957,10423,0,4712,18821,16704,2117
10/12/2016 2:00,32402,10179,0,4712,17512,16646,866
10/12/2016 3:00,31525,10079,0,4712,16734,17455,-721
10/12/2016 4:00,31175,9187,0,4712,17276,19349,-2073
10/12/2016 5:00,31549,8671,0,4712,18166,22260,-4094
10/12/2016 6:00,33290,9247,0,4712,19332,22859,-3527
10/12/2016 7:00,36622,9410,8,4712,22493,23459,-966
10/12/2016 8:00,37793,8089,250,4712,24742,26598,-1856
10/12/2016 9:00,38214,6989,349,4712,26164,29144,-2980
10/12/2016 10:00,40338,5996,425,4712,29205,32696,-3491
10/12/2016 11:00,43082,4839,452,4712,33079,36098,-3019
10/12/2016 12:00,45737,3948,464,4712,36613,38884,-2271
10/12/2016 13:00,48141,3848,461,4712,39120,39847,-727
10/12/2016 14:00,50648,5520,437,4712,39980,39846,134
10/12/2016 15:00,52880,7094,383,4712,40691,39352,1339
10/12/2016 16:00,54583,8095,318,4712,41458,38458,3000
10/12/2016 17:00,55472,8117,198,4712,42445,36406,6039
10/12/2016 18:00,54814,8030,2,4712,42070,35433,6637
10/12/2016 19:00,52354,8752,0,4712,38890,32310,6580
10/12/2016 20:00,51038,9138,0,4712,37188,29189,7999
10/12/2016 21:00,48999,8409,0,4712,35878,26713,9165
10/12/2016 22:00,45924,6959,0,4712,34254,24925,9329
10/12/2016 23:00,42059,6669,0,4712,30678,23423,7255
10/13/2016 0:00,38005,5747,0,4712,27546,22718,4828
10/13/2016 1:00,35186,4650,0,4712,25824,22227,3597
10/13/2016 2:00,33296,4105,0,4712,24479,22206,2273
10/13/2016 3:00,32062,3410,0,4712,23940,23025,915
10/13/2016 4:00,31358,2740,0,4712,23906,25011,-1105
10/13/2016 5:00,31476,1992,0,4712,24772,27883,-3111
10/13/2016 6:00,33120,2003,0,4712,26405,28950,-2545
10/13/2016 7:00,36289,1591,12,4712,29974,29216,758
10/13/2016 8:00,37404,1246,272,4712,31174,30794,380
10/13/2016 9:00,37642,1040,406,4712,31484,32349,-865
10/13/2016 10:00,39374,814,424,4712,33424,34056,-632
10/13/2016 11:00,41436,1100,457,4712,35167,35195,-28
10/13/2016 12:00,43281,1464,476,4712,36629,36626,3
10/13/2016 13:00,45043,2045,476,4712,37810,37207,603
10/13/2016 14:00,47031,2416,467,4712,39436,37766,1670
10/13/2016 15:00,48433,2635,434,4712,40652,37941,2711
10/13/2016 16:00,49141,2694,373,4712,41362,37037,4325
10/13/2016 17:00,49366,3255,262,4712,41137,35178,5959
10/13/2016 18:00,48456,3108,80,4712,40556,35398,5158
10/13/2016 19:00,46610,3088,0,4712,38810,33843,4967
10/13/2016 20:00,46405,3484,0,4712,38209,31218,6991
10/13/2016 21:00,45188,3892,0,4712,36584,28114,8470
10/13/2016 22:00,42731,4080,0,4712,33938,24801,9137
10/13/2016 23:00,39421,4207,0,4712,30502,22932,7570
10/14/2016 0:00,36039,3894,0,4712,27433,21706,5727
10/14/2016 1:00,33519,4097,0,4712,24711,20875,3836
10/14/2016 2:00,31855,3452,0,4712,23690,21172,2518
10/14/2016 3:00,30698,2781,0,4712,23205,21853,1352
10/14/2016 4:00,30343,2388,0,4712,23243,23534,-291
10/14/2016 5:00,30665,2150,0,4712,23803,26409,-2606
10/14/2016 6:00,32390,2009,0,4712,25669,27604,-1935
10/14/2016 7:00,35467,2165,9,4712,28580,27831,749
10/14/2016 8:00,36957,2264,313,4712,29667,28725,942
10/14/2016 9:00,37312,2427,379,4712,29793,29829,-36
10/14/2016 10:00,38818,2895,436,4712,30775,30665,110
10/14/2016 11:00,40662,3479,466,4712,32005,31171,834
10/14/2016 12:00,42167,4389,484,4712,32582,31608,974
10/14/2016 13:00,43457,5136,483,4712,33126,32463,663
10/14/2016 14:00,44995,5111,468,4712,34704,33177,1527
10/14/2016 15:00,46241,5149,451,4712,35929,33831,2098
10/14/2016 16:00,47226,5277,397,4712,36839,33194,3645
10/14/2016 17:00,47745,5581,287,4712,37166,31335,5831
10/14/2016 18:00,46873,6304,18,4712,35839,29383,6456
10/14/2016 19:00,45082,8379,0,4712,31991,26833,5158
10/14/2016 20:00,44460,10146,0,4712,29602,24400,5202
10/14/2016 21:00,43253,11156,0,4712,27385,22035,5350
10/14/2016 22:00,41465,11512,0,4712,25241,19647,5594
10/14/2016 23:00,39247,11422,0,4712,23114,17947,5167
10/15/2016 0:00,36677,11279,0,4712,20686,16763,3923
10/15/2016 1:00,34275,11779,0,4712,17784,15556,2228
10/15/2016 2:00,32592,11809,0,4712,16071,14964,1107
10/15/2016 3:00,31475,11657,0,4712,15106,14909,197
10/15/2016 4:00,30796,11421,0,4712,14663,15439,-776
10/15/2016 5:00,30586,11074,0,4712,14800,16602,-1802
10/15/2016 6:00,30993,10815,0,4712,15466,17867,-2401
10/15/2016 7:00,32102,10822,24,4712,16544,19420,-2876
10/15/2016 8:00,33152,10012,204,4712,18224,22019,-3795
10/15/2016 9:00,34719,10282,331,4712,19394,23753,-4359
10/15/2016 10:00,37577,10499,380,4712,21987,26503,-4516
10/15/2016 11:00,40621,9805,414,4712,25689,29213,-3524
10/15/2016 12:00,43467,9151,475,4712,29128,31774,-2646
10/15/2016 13:00,45978,8655,477,4712,32133,33389,-1256
10/15/2016 14:00,48241,8518,462,4712,34549,34358,191
10/15/2016 15:00,50005,7980,440,4712,36874,35211,1663
10/15/2016 16:00,51096,8434,376,4712,37574,34706,2868
10/15/2016 17:00,51542,7966,259,4712,38605,32875,5730
10/15/2016 18:00,50836,8222,7,4712,37894,30723,7171
10/15/2016 19:00,48709,10531,0,4712,33466,28534,4932
10/15/2016 20:00,47823,11677,0,4712,31434,26145,5289
10/15/2016 21:00,46137,12261,0,4712,29165,23984,5181
10/15/2016 22:00,44103,11759,0,4712,27632,21899,5733
10/15/2016 23:00,41641,11684,0,4712,25245,19522,5723
10/16/2016 0:00,38977,11685,0,4712,22579,17804,4775
10/16/2016 1:00,36368,11689,0,4712,19967,16853,3114
10/16/2016 2:00,34413,11610,0,4712,18091,16256,1835
10/16/2016 3:00,32974,11494,0,4712,16768,15704,1064
10/16/2016 4:00,32089,11622,0,4712,15755,16125,-370
10/16/2016 5:00,31652,11075,0,4712,15864,16992,-1128
10/16/2016 6:00,31727,10837,0,4712,16178,17844,-1666
10/16/2016 7:00,32332,10575,0,4712,17045,19864,-2819
10/16/2016 8:00,32902,8863,52,4712,19275,23409,-4134
10/16/2016 9:00,34477,7941,133,4712,21691,26050,-4359
10/16/2016 10:00,37785,8091,218,4712,24764,28572,-3808
10/16/2016 11:00,41147,8258,354,4712,27822,31112,-3290
10/16/2016 12:00,44339,8668,314,4712,30644,32730,-2086
10/16/2016 13:00,47453,9457,314,4712,32970,34403,-1433
10/16/2016 14:00,50164,9632,324,4712,35495,35460,35
10/16/2016 15:00,52370,9702,340,4712,37616,35870,1746
10/16/2016 16:00,53723,9716,250,4712,39045,35671,3374
10/16/2016 17:00,54233,9324,171,4712,40026,33859,6167
10/16/2016 18:00,53656,9975,18,4712,38951,32268,6683
10/16/2016 19:00,51544,12073,0,4712,34759,29409,5350
10/16/2016 20:00,51006,12600,0,4712,33695,26859,6836
10/16/2016 21:00,49292,12894,0,4712,31686,23895,7791
10/16/2016 22:00,46518,12860,0,4712,28947,20911,8036
10/16/2016 23:00,43121,12548,0,4712,25861,18628,7233
10/17/2016 0:00,39570,12398,0,4712,22459,17212,5247
10/17/2016 1:00,36600,12051,0,4712,19837,16676,3161
10/17/2016 2:00,34790,12114,0,4712,17964,16247,1717
10/17/2016 3:00,33642,11897,0,4712,17033,16916,117
10/17/2016 4:00,33176,11642,0,4712,16821,18684,-1863
10/17/2016 5:00,33581,11678,0,4712,17191,21971,-4780
10/17/2016 6:00,35559,11840,0,4712,19006,23255,-4249
10/17/2016 7:00,38806,11423,12,4712,22659,24074,-1415
10/17/2016 8:00,40031,10496,294,4712,24529,26235,-1706
10/17/2016 9:00,40464,10322,379,4712,25051,28461,-3410
10/17/2016 10:00,42816,9967,407,4712,27730,30839,-3109
10/17/2016 11:00,45507,9781,422,4712,30593,33177,-2584
10/17/2016 12:00,48186,9934,455,4712,33085,35488,-2403
10/17/2016 13:00,50928,10031,412,4712,35772,37681,-1909
10/17/2016 14:00,53709,10566,337,4712,38094,38666,-572
10/17/2016 15:00,55871,10647,371,4712,40141,39124,1017
10/17/2016 16:00,57348,10705,261,4712,41670,38748,2922
10/17/2016 17:00,57952,9763,166,4712,43312,37017,6295
10/17/2016 18:00,56959,10273,2,4712,41972,34466,7506
10/17/2016 19:00,54571,12542,0,4712,37317,31486,5831
10/17/2016 20:00,53647,13315,0,4712,35620,28442,7178
10/17/2016 21:00,51640,13218,0,4712,33710,25447,8263
10/17/2016 22:00,48550,13139,0,4712,30699,22461,8238
10/17/2016 23:00,44692,12701,0,4712,27279,19935,7344
10/18/2016 0:00,40878,13019,0,4712,23147,18878,4269
10/18/2016 1:00,37968,12041,0,4712,21215,18381,2834
10/18/2016 2:00,36081,11571,0,4712,19798,18419,1379
10/18/2016 3:00,34764,10785,0,4712,19267,19117,150
10/18/2016 4:00,34052,10120,0,4712,19220,21487,-2267
10/18/2016 5:00,34193,8636,0,4712,20845,25763,-4918
10/18/2016 6:00,35856,7214,0,4712,23929,27760,-3831
10/18/2016 7:00,39135,6245,19,4712,28158,28892,-734
10/18/2016 8:00,40203,4335,306,4712,30850,31230,-380
10/18/2016 9:00,40576,4630,393,4712,30841,33005,-2164
10/18/2016 10:00,42848,4727,410,4712,32999,36250,-3251
10/18/2016 11:00,45592,3108,443,4712,37330,40003,-2673
10/18/2016 12:00,48324,2003,461,4712,41149,43059,-1910
10/18/2016 13:00,50911,1736,460,4712,44004,45248,-1244
10/18/2016 14:00,53746,1809,454,4712,46770,46137,633
10/18/2016 15:00,56143,2075,415,4712,48942,46224,2718
10/18/2016 16:00,57523,2529,342,4712,49940,45147,4793
10/18/2016 17:00,58007,3087,285,4712,49923,42978,6945
10/18/2016 18:00,56886,3442,16,4712,48716,41119,7597
10/18/2016 19:00,54268,4472,0,4712,45085,38451,6634
10/18/2016 20:00,53230,5266,0,4712,43252,35424,7828
10/18/2016 21:00,51160,5188,0,4712,41260,32241,9019
10/18/2016 22:00,48168,5220,0,4712,38236,28220,10016
10/18/2016 23:00,44462,5360,0,4712,34391,25945,8446
10/19/2016 0:00,40560,5208,0,4712,30640,24106,6534
10/19/2016 1:00,37589,6142,0,4712,26735,22481,4254
10/19/2016 2:00,35786,6947,0,4712,24127,21633,2494
10/19/2016 3:00,34616,6877,0,4712,23027,22193,834
10/19/2016 4:00,33997,6145,0,4712,23140,24666,-1526
10/19/2016 5:00,34195,5656,0,4712,23827,27955,-4128
10/19/2016 6:00,36007,5661,0,4712,25634,28928,-3294
10/19/2016 7:00,39472,5284,21,4712,29455,29525,-70
10/19/2016 8:00,40767,4317,219,4712,31519,31955,-436
10/19/2016 9:00,40952,3745,309,4712,32186,33663,-1477
10/19/2016 10:00,43172,4723,359,4712,33378,36170,-2792
10/19/2016 11:00,45792,4687,387,4712,36006,38585,-2579
10/19/2016 12:00,48333,4291,415,4712,38915,40916,-2001
10/19/2016 13:00,50870,3698,465,4712,41995,42801,-806
10/19/2016 14:00,53253,3472,454,4712,44616,43839,777
10/19/2016 15:00,55052,3671,413,4712,46255,43939,2316
10/19/2016 16:00,56145,3844,339,4712,47250,43050,4200
10/19/2016 17:00,56456,3844,277,4712,47624,41146,6478
10/19/2016 18:00,55388,4791,14,4712,45871,38665,7206
10/19/2016 19:00,53183,7271,0,4712,41200,34263,6937
10/19/2016 20:00,52299,8948,0,4712,38640,30413,8227
10/19/2016 21:00,50043,9399,0,4712,35932,26902,9030
10/19/2016 22:00,47156,9063,0,4712,33381,23614,9767
10/19/2016 23:00,43741,8673,0,4712,30355,21371,8984
10/20/2016 0:00,39741,8968,0,4712,26061,19332,6729
10/20/2016 1:00,36739,9884,0,4712,22143,17852,4291
10/20/2016 2:00,34802,10048,0,4712,20042,17635,2407
10/20/2016 3:00,33536,9829,0,4712,18995,17930,1065
10/20/2016 4:00,32854,9563,0,4712,18579,19231,-652
10/20/2016 5:00,32992,10027,0,4712,18253,21819,-3566
10/20/2016 6:00,34651,10155,0,4712,19784,22828,-3044
10/20/2016 7:00,37847,9688,0,4712,23447,22999,448
10/20/2016 8:00,38950,9005,80,4712,25153,23952,1201
10/20/2016 9:00,38679,9157,161,4712,24649,25218,-569
10/20/2016 10:00,39846,9479,199,4712,25456,25618,-162
10/20/2016 11:00,41693,10113,378,4712,26489,26307,182
10/20/2016 12:00,43009,9881,401,4712,28015,27385,630
10/20/2016 13:00,43936,9275,415,4712,29535,28008,1527
10/20/2016 14:00,44811,8686,427,4712,30986,28189,2797
10/20/2016 15:00,45039,8270,363,4712,31694,28391,3303
10/20/2016 16:00,44931,7014,285,4712,32920,28752,4168
10/20/2016 17:00,44483,5648,229,4712,33894,29711,4183
10/20/2016 18:00,43224,3652,14,4712,34846,30528,4318
10/20/2016 19:00,41659,3788,0,4712,33159,29584,3575
10/20/2016 20:00,41701,3930,0,4712,33059,27312,5747
10/20/2016 21:00,40648,3893,0,4712,32044,24506,7538
10/20/2016 22:00,38669,3927,0,4712,30029,21689,8340
10/20/2016 23:00,35650,4263,0,4712,26675,19647,7028
10/21/2016 0:00,32331,4576,0,4712,23044,17830,5214
10/21/2016 1:00,29884,4778,0,4712,20394,17080,3314
10/21/2016 2:00,28356,5224,0,4712,18420,16661,1759
10/21/2016 3:00,27434,5377,0,4712,17345,16965,380
10/21/2016 4:00,26998,5142,0,4712,17144,18291,-1147
10/21/2016 5:00,27236,4639,0,4712,17885,20136,-2251
10/21/2016 6:00,28745,5067,0,4712,18966,20920,-1954
10/21/2016 7:00,31826,5158,0,4712,21956,20742,1214
10/21/2016 8:00,33103,4948,158,4712,23285,21692,1593
10/21/2016 9:00,33108,4277,199,4712,23919,22355,1564
10/21/2016 10:00,33935,4673,256,4712,24295,23122,1173
10/21/2016 11:00,34935,4153,331,4712,25739,24106,1633
10/21/2016 12:00,35658,3639,348,4712,26959,25611,1348
10/21/2016 13:00,36271,3210,353,4712,27996,26422,1574
10/21/2016 14:00,37113,3048,368,4712,28985,27223,1762
10/21/2016 15:00,37911,2737,349,4712,30112,27784,2328
10/21/2016 16:00,38640,2804,285,4712,30840,27398,3442
10/21/2016 17:00,39119,3023,179,4712,31205,26255,4950
10/21/2016 18:00,38637,3809,1,4712,30115,24784,5331
10/21/2016 19:00,37221,6026,0,4712,26483,22493,3990
10/21/2016 20:00,37048,7069,0,4712,25267,20558,4709
10/21/2016 21:00,35890,7507,0,4712,23672,18442,5230
10/21/2016 22:00,34339,8075,0,4712,21551,16349,5202
10/21/2016 23:00,32262,8329,0,4712,19221,14632,4589
10/22/2016 0:00,30051,8121,0,4712,17218,13740,3478
10/22/2016 1:00,28116,8176,0,4712,15228,13262,1966
10/22/2016 2:00,26761,8008,0,4712,14041,13013,1028
10/22/2016 3:00,26032,8186,0,4712,13134,12896,238
10/22/2016 4:00,25685,8106,0,4712,12867,13332,-465
10/22/2016 5:00,25598,7837,0,4712,13049,14281,-1232
10/22/2016 6:00,26084,7876,0,4712,13496,15334,-1838
10/22/2016 7:00,27266,7505,0,4712,15049,16492,-1443
10/22/2016 8:00,28438,6711,138,4712,16877,19388,-2511
10/22/2016 9:00,29557,4368,189,4712,20287,21233,-946
10/22/2016 10:00,30997,4209,275,4712,21801,21541,260
10/22/2016 11:00,32012,4208,367,4712,22725,21786,939
10/22/2016 12:00,32675,4190,424,4712,23349,22133,1216
10/22/2016 13:00,33344,4729,432,4712,23471,22131,1340
10/22/2016 14:00,34138,5573,435,4712,23419,22373,1046
10/22/2016 15:00,35100,5589,372,4712,24427,22779,1648
10/22/2016 16:00,36086,6101,309,4712,24964,22334,2630
10/22/2016 17:00,36806,6558,207,4712,25328,21465,3863
10/22/2016 18:00,36691,7553,0,4712,24425,20299,4126
10/22/2016 19:00,35826,10322,0,4712,20792,17962,2830
10/22/2016 20:00,36122,11491,0,4712,19919,16400,3519
10/22/2016 21:00,35141,11944,0,4712,18485,14821,3664
10/22/2016 22:00,33794,12191,0,4712,16891,13379,3512
10/22/2016 23:00,32076,11944,0,4712,15420,12406,3014
10/23/2016 0:00,30021,11043,0,4712,14266,11962,2304
10/23/2016 1:00,28213,10622,0,4712,12879,11705,1174
10/23/2016 2:00,26997,10521,0,4712,11764,11583,181
10/23/2016 3:00,26154,10159,0,4712,11283,11718,-435
10/23/2016 4:00,25688,10182,0,4712,10794,12242,-1448
10/23/2016 5:00,25583,9339,0,4712,11532,13548,-2016
10/23/2016 6:00,25827,8489,0,4712,12627,14944,-2317
10/23/2016 7:00,26494,7924,0,4712,13858,16123,-2265
10/23/2016 8:00,27224,7399,131,4712,14982,17846,-2864
10/23/2016 9:00,28279,5583,218,4712,17765,19820,-2055
10/23/2016 10:00,30106,5408,325,4712,19661,21060,-1399
10/23/2016 11:00,31551,5394,196,4712,21249,22371,-1122
10/23/2016 12:00,32866,4835,278,4712,23040,24088,-1048
10/23/2016 13:00,34157,4248,305,4712,24892,25615,-723
10/23/2016 14:00,35288,3643,291,4712,26642,26027,615
10/23/2016 15:00,36323,4044,239,4712,27328,26330,998
10/23/2016 16:00,37187,4632,218,4712,27624,25805,1819
10/23/2016 17:00,37889,5794,138,4712,27245,25468,1777
10/23/2016 18:00,38097,6788,2,4712,26595,25196,1399
10/23/2016 19:00,38165,8494,0,4712,24959,23185,1774
10/23/2016 20:00,39501,9397,0,4712,25392,21288,4104
10/23/2016 21:00,38714,9595,0,4712,24407,18729,5678
10/23/2016 22:00,37167,9378,0,4712,23077,17180,5897
10/23/2016 23:00,34617,8757,0,4712,21147,15984,5163
10/24/2016 0:00,31817,8344,0,4712,18761,14985,3776
10/24/2016 1:00,29676,8120,0,4712,16844,14876,1968
10/24/2016 2:00,28376,7702,0,4712,15962,15362,600
10/24/2016 3:00,27638,6708,0,4712,16217,15968,249
10/24/2016 4:00,27537,6430,0,4712,16394,17749,-1355
10/24/2016 5:00,28035,5858,0,4712,17465,21568,-4103
10/24/2016 6:00,29907,5028,0,4712,20167,23759,-3592
10/24/2016 7:00,33249,4508,0,4712,24029,24419,-390
10/24/2016 8:00,34820,3252,121,4712,26734,26810,-76
10/24/2016 9:00,34817,2122,129,4712,27854,28792,-938
10/24/2016 10:00,36142,2227,210,4712,28993,30405,-1412
10/24/2016 11:00,38022,1853,215,4712,31242,32721,-1479
10/24/2016 12:00,39925,1523,110,4712,33579,34218,-639
10/24/2016 13:00,41811,1767,80,4712,35252,34939,313
10/24/2016 14:00,43649,2388,105,4712,36444,35390,1054
10/24/2016 15:00,45178,2940,59,4712,37467,35362,2105
10/24/2016 16:00,46359,3857,48,4712,37742,34183,3559
10/24/2016 17:00,47017,4835,117,4712,37353,32287,5066
10/24/2016 18:00,46471,5936,6,4712,35817,31066,4751
10/24/2016 19:00,45234,8041,0,4712,32481,28153,4328
10/24/2016 20:00,45329,9793,0,4712,30825,24842,5983
10/24/2016 21:00,43883,10654,0,4712,28517,20882,7635
10/24/2016 22:00,41470,10792,0,4712,25966,18032,7934
10/24/2016 23:00,38048,10739,0,4712,22596,16746,5850
10/25/2016 0:00,34419,10462,0,4712,19245,15546,3699
10/25/2016 1:00,31839,10048,0,4712,17078,14723,2355
10/25/2016 2:00,30232,9719,0,4712,15800,14904,896
10/25/2016 3:00,29091,8956,0,4712,15424,15612,-188
10/25/2016 4:00,28548,8308,0,4712,15528,18035,-2507
10/25/2016 5:00,28763,7736,0,4712,16314,20858,-4544
10/25/2016 6:00,30401,6821,0,4712,18869,22132,-3263
10/25/2016 7:00,33747,6634,0,4712,22401,22617,-216
10/25/2016 8:00,35106,6049,169,4712,24176,24447,-271
10/25/2016 9:00,35042,5428,250,4712,24652,25587,-935
10/25/2016 10:00,36312,6345,318,4712,24938,26234,-1296
10/25/2016 11:00,38113,6776,339,4712,26286,27792,-1506
10/25/2016 12:00,39830,6240,361,4712,28517,29637,-1120
10/25/2016 13:00,41443,6011,396,4712,30324,30830,-506
10/25/2016 14:00,43119,6534,392,4712,31481,30996,485
10/25/2016 15:00,44349,6979,366,4712,32291,30916,1375
10/25/2016 16:00,45111,7883,320,4712,32197,30029,2168
10/25/2016 17:00,45504,7509,216,4712,33067,30041,3026
10/25/2016 18:00,44633,7186,1,4712,32735,30506,2229
10/25/2016 19:00,43759,8253,0,4712,30794,28392,2402
10/25/2016 20:00,44248,9549,0,4712,29987,25597,4390
10/25/2016 21:00,43113,10418,0,4712,27983,21746,6237
10/25/2016 22:00,40920,10792,0,4712,25416,18939,6477
10/25/2016 23:00,37760,10722,0,4712,22325,16779,5546
10/26/2016 0:00,34326,10353,0,4712,19261,16234,3027
10/26/2016 1:00,31754,9532,0,4712,17510,15791,1719
10/26/2016 2:00,30120,8988,0,4712,16421,15960,461
10/26/2016 3:00,29026,8200,0,4712,16114,16553,-439
10/26/2016 4:00,28484,7569,0,4712,16203,18655,-2452
10/26/2016 5:00,28640,7252,0,4712,16677,21594,-4917
10/26/2016 6:00,30317,7179,0,4712,18426,22650,-4224
10/26/2016 7:00,33724,7433,2,4712,21577,22754,-1177
10/26/2016 8:00,35041,6738,193,4712,23398,25203,-1805
10/26/2016 9:00,35021,5590,281,4712,24439,26575,-2136
10/26/2016 10:00,36504,5360,382,4712,26050,29138,-3088
10/26/2016 11:00,38399,4313,438,4712,28936,31941,-3005
10/26/2016 12:00,40457,3233,462,4712,32050,34441,-2391
10/26/2016 13:00,42516,2880,462,4712,34462,36279,-1817
10/26/2016 14:00,44748,2646,443,4712,36947,37242,-295
10/26/2016 15:00,46619,2813,392,4712,38702,37810,892
10/26/2016 16:00,48001,2835,369,4712,40085,37483,2602
10/26/2016 17:00,48707,2540,252,4712,41203,36436,4767
10/26/2016 18:00,47961,2672,0,4712,40576,35810,4766
10/26/2016 19:00,46169,3747,0,4712,37710,33360,4350
10/26/2016 20:00,45901,4349,0,4712,36840,30609,6231
10/26/2016 21:00,44353,4546,0,4712,35095,27443,7652
10/26/2016 22:00,41878,4423,0,4712,32743,24721,8022
10/26/2016 23:00,38557,4321,0,4712,29524,22189,7335
10/27/2016 0:00,34794,4117,0,4712,25965,21824,4141
10/27/2016 1:00,31980,3767,0,4712,23501,21583,1918
10/27/2016 2:00,30237,2951,0,4712,22574,21405,1169
10/27/2016 3:00,29056,2647,0,4712,21697,21871,-174
10/27/2016 4:00,28409,1994,0,4712,21703,23460,-1757
10/27/2016 5:00,28674,1289,0,4712,22673,26347,-3674
10/27/2016 6:00,30374,1051,0,4712,24611,27844,-3233
10/27/2016 7:00,33754,877,5,4712,28160,28015,145
10/27/2016 8:00,35240,659,313,4712,29556,29703,-147
10/27/2016 9:00,35286,316,360,4712,29898,32119,-2221
10/27/2016 10:00,36902,452,420,4712,31318,34008,-2690
10/27/2016 11:00,39077,468,453,4712,33445,36312,-2867
10/27/2016 12:00,41187,540,467,4712,35468,38481,-3013
10/27/2016 13:00,43493,709,465,4712,37606,39233,-1627
10/27/2016 14:00,45855,1090,454,4712,39599,39927,-328
10/27/2016 15:00,47714,1363,412,4712,41226,40134,1092
10/27/2016 16:00,49008,1785,340,4712,42171,39172,2999
10/27/2016 17:00,49645,2365,275,4712,42293,37333,4960
10/27/2016 18:00,48695,3349,0,4712,40634,35865,4769
10/27/2016 19:00,46752,4787,0,4712,37253,32232,5021
10/27/2016 20:00,46296,6424,0,4712,35160,28656,6504
10/27/2016 21:00,44664,7658,0,4712,32294,24913,7381
10/27/2016 22:00,42133,8616,0,4712,28805,21397,7408
10/27/2016 23:00,38745,9201,0,4712,24832,18502,6330
10/28/2016 0:00,35192,9096,0,4712,21384,17073,4311
10/28/2016 1:00,32448,8768,0,4712,18968,16351,2617
10/28/2016 2:00,30639,8656,0,4712,17270,15962,1308
10/28/2016 3:00,29531,8642,0,4712,16176,16271,-95
10/28/2016 4:00,28981,8646,0,4712,15622,18232,-2610
10/28/2016 5:00,29159,8305,0,4712,16142,21067,-4925
10/28/2016 6:00,30745,7976,0,4712,18057,21621,-3564
10/28/2016 7:00,33961,7731,6,4712,21512,22350,-838
10/28/2016 8:00,35329,6778,209,4712,23630,24694,-1064
10/28/2016 9:00,35329,5902,231,4712,24484,26796,-2312
10/28/2016 10:00,36985,6314,286,4712,25673,28439,-2766
10/28/2016 11:00,39221,6702,267,4712,27540,29643,-2103
10/28/2016 12:00,41307,7250,253,4712,29092,31098,-2006
10/28/2016 13:00,43244,7269,269,4712,30993,33000,-2007
10/28/2016 14:00,45296,6676,232,4712,33675,33951,-276
10/28/2016 15:00,46910,6493,192,4712,35513,34476,1037
10/28/2016 16:00,48083,6487,230,4712,36653,33601,3052
10/28/2016 17:00,48589,6547,132,4712,37197,31762,5435
10/28/2016 18:00,47417,6901,0,4712,35803,30271,5532
10/28/2016 19:00,45019,8787,0,4712,31521,26842,4679
10/28/2016 20:00,43946,10412,0,4712,28823,24207,4616
10/28/2016 21:00,42004,11095,0,4712,26197,21281,4916
10/28/2016 22:00,39996,11138,0,4712,24146,19233,4913
10/28/2016 23:00,37595,11155,0,4712,21729,17006,4723
10/29/2016 0:00,34944,11481,0,4712,18751,15151,3600
10/29/2016 1:00,32438,11215,0,4712,16511,14511,2000
10/29/2016 2:00,30711,10997,0,4712,15002,14185,817
10/29/2016 3:00,29510,10601,0,4712,14196,14067,129
10/29/2016 4:00,28766,10524,0,4712,13530,14896,-1366
10/29/2016 5:00,28564,10141,0,4712,13712,16718,-3006
10/29/2016 6:00,29018,9898,0,4712,14408,17781,-3373
10/29/2016 7:00,30073,9727,3,4712,15632,19359,-3727
10/29/2016 8:00,31250,8778,298,4712,17462,22005,-4543
10/29/2016 9:00,32517,7754,337,4712,19715,24072,-4357
10/29/2016 10:00,34719,8018,395,4712,21595,25643,-4048
10/29/2016 11:00,37200,7953,428,4712,24107,28468,-4361
10/29/2016 12:00,39520,6823,391,4712,27594,30936,-3342
10/29/2016 13:00,41626,6210,385,4712,30318,32449,-2131
10/29/2016 14:00,43557,5576,370,4712,32898,33451,-553
10/29/2016 15:00,45183,5356,205,4712,34910,33504,1406
10/29/2016 16:00,46297,5366,213,4712,36006,33163,2843
10/29/2016 17:00,46653,5114,151,4712,36676,31769,4907
10/29/2016 18:00,45589,5940,0,4712,34937,29238,5699
10/29/2016 19:00,43704,8994,0,4712,29998,25987,4011
10/29/2016 20:00,43154,10645,0,4712,27797,23250,4547
10/29/2016 21:00,41389,10888,0,4712,25789,20444,5345
10/29/2016 22:00,39473,11799,0,4712,22961,18109,4852
10/29/2016 23:00,37239,11765,0,4712,20762,16388,4374
10/30/2016 0:00,34704,11643,0,4712,18348,15332,3016
10/30/2016 1:00,32435,10855,0,4712,16867,15073,1794
10/30/2016 2:00,30712,9911,0,4712,16090,15318,772
10/30/2016 3:00,29510,8854,0,4712,15944,15437,507
10/30/2016 4:00,28681,8598,0,4712,15371,15868,-497
10/30/2016 5:00,28227,7695,0,4712,15821,17411,-1590
10/30/2016 6:00,28249,6648,0,4712,16890,18837,-1947
10/30/2016 7:00,28672,6131,0,4712,17829,20257,-2428
10/30/2016 8:00,29484,5213,151,4712,19408,23232,-3824
10/30/2016 9:00,30618,3471,179,4712,22257,26325,-4068
10/30/2016 10:00,33028,2350,232,4712,25733,29975,-4242
10/30/2016 11:00,35648,1403,255,4712,29277,33901,-4624
10/30/2016 12:00,38422,780,267,4712,32663,36385,-3722
10/30/2016 13:00,41246,618,286,4712,35630,38125,-2495
10/30/2016 14:00,43872,713,261,4712,38186,39195,-1009
10/30/2016 15:00,46037,1042,230,4712,40053,39025,1028
10/30/2016 16:00,47568,1529,193,4712,41135,38201,2934
10/30/2016 17:00,48156,2405,130,4712,40909,35886,5023
10/30/2016 18:00,47482,3518,0,4712,39252,34336,4916
10/30/2016 19:00,45682,5184,0,4712,35786,30578,5208
10/30/2016 20:00,45221,6580,0,4712,33929,26647,7282
10/30/2016 21:00,43175,7882,0,4712,30582,22221,8361
10/30/2016 22:00,40848,9364,0,4712,26772,19206,7566
10/30/2016 23:00,37584,9973,0,4712,22899,17111,5788
10/31/2016 0:00,34498,10291,0,4712,19495,15495,4000
10/31/2016 1:00,31747,10471,0,4712,16564,14801,1763
10/31/2016 2:00,29982,10268,0,4712,15002,14709,293
10/31/2016 3:00,28985,10355,0,4712,13918,15056,-1138
10/31/2016 4:00,28585,10140,0,4712,13732,16772,-3040
10/31/2016 5:00,28969,9790,0,4712,14467,19808,-5341
10/31/2016 6:00,30728,9420,0,4712,16596,21028,-4432
10/31/2016 7:00,34001,8997,0,4712,20292,21880,-1588
10/31/2016 8:00,35478,7518,179,4712,23069,23967,-898
10/31/2016 9:00,35334,6552,284,4712,23786,25648,-1862
10/31/2016 10:00,36657,7130,321,4712,24494,27296,-2802
10/31/2016 11:00,38719,6976,305,4712,26726,29384,-2658
10/31/2016 12:00,40833,6805,301,4712,29015,31070,-2055
10/31/2016 13:00,42882,7201,304,4712,30665,32079,-1414
10/31/2016 14:00,45084,7447,293,4712,32632,33070,-438
10/31/2016 15:00,46912,7736,286,4712,34178,33568,610
10/31/2016 16:00,48238,7878,262,4712,35386,32648,2738
10/31/2016 17:00,48858,7787,167,4712,36192,30808,5384
10/31/2016 18:00,47877,8047,0,4712,35118,28131,6987
10/31/2016 19:00,45486,10595,0,4712,30179,25507,4672
10/31/2016 20:00,44110,12354,0,4712,27044,23638,3406
10/31/2016 21:00,42919,12635,0,4712,25571,21222,4349
10/31/2016 22:00,41848,12643,0,4712,24493,18783,5710
10/31/2016 23:00,39095,12249,0,4712,22135,16724,5411
11/1/2016 0:00,35887,11880,0,4712,19295,15571,3724
11/1/2016 1:00,33396,11852,0,4712,16832,14841,1991
11/1/2016 2:00,32007,11595,0,4712,15699,14935,764
11/1/2016 3:00,31183,11233,0,4712,15238,15990,-752
11/1/2016 4:00,30726,10776,0,4712,15238,18446,-3208
11/1/2016 5:00,30970,10267,0,4712,15991,22093,-6102
11/1/2016 6:00,32790,9352,0,4712,18727,23909,-5182
11/1/2016 7:00,36306,8506,1,4712,23088,24368,-1280
11/1/2016 8:00,37956,7662,288,4712,25293,26419,-1126
11/1/2016 9:00,37922,6978,378,4712,25855,28041,-2186
11/1/2016 10:00,39415,7010,398,4712,27295,30218,-2923
11/1/2016 11:00,41446,5984,433,4712,30317,32671,-2354
11/1/2016 12:00,43439,4944,457,4712,33327,34860,-1533
11/1/2016 13:00,45030,4484,453,4712,35381,35970,-589
11/1/2016 14:00,46529,4703,430,4712,36684,36464,220
11/1/2016 15:00,47936,4878,370,4712,37975,36846,1129
11/1/2016 16:00,49018,5146,341,4712,38819,36402,2417
11/1/2016 17:00,49708,5268,200,4712,39528,35879,3649
11/1/2016 18:00,49276,6018,0,4712,38545,34503,4042
11/1/2016 19:00,48373,8431,0,4712,35230,31287,3943
11/1/2016 20:00,48427,10122,0,4712,33593,28017,5576
11/1/2016 21:00,47172,11487,0,4712,30974,24289,6685
11/1/2016 22:00,44811,11957,0,4712,28142,21004,7138
11/1/2016 23:00,41618,12265,0,4712,24641,18844,5797
11/2/2016 0:00,38069,12316,0,4712,21041,17826,3215
11/2/2016 1:00,35376,11701,0,4712,18963,17731,1232
11/2/2016 2:00,33743,10765,0,4712,18266,17737,529
11/2/2016 3:00,32738,10081,0,4712,17944,18842,-898
11/2/2016 4:00,32185,8934,0,4712,18539,21022,-2483
11/2/2016 5:00,32493,8394,0,4712,19388,24609,-5221
11/2/2016 6:00,34205,7407,0,4712,22086,27299,-5213
11/2/2016 7:00,37656,6944,2,4712,25998,27499,-1501
11/2/2016 8:00,39256,5603,232,4712,28709,29139,-430
11/2/2016 9:00,39049,5270,359,4712,28707,30415,-1708
11/2/2016 10:00,40566,6340,420,4712,29095,31642,-2547
11/2/2016 11:00,42521,6196,451,4712,31162,33989,-2827
11/2/2016 12:00,44350,5306,465,4712,33867,36400,-2533
11/2/2016 13:00,46086,4586,468,4712,36320,37804,-1484
11/2/2016 14:00,48047,4616,451,4712,38269,38082,187
11/2/2016 15:00,49481,5178,387,4712,39205,37294,1911
11/2/2016 16:00,49994,6204,370,4712,38708,36095,2613
11/2/2016 17:00,49960,5602,248,4712,39398,35659,3739
11/2/2016 18:00,48981,6163,0,4712,38106,35292,2814
11/2/2016 19:00,48122,6576,0,4712,36834,33962,2872
11/2/2016 20:00,48289,6643,0,4712,36934,31128,5806
11/2/2016 21:00,46911,8501,0,4712,33698,27694,6004
11/2/2016 22:00,44755,8138,0,4712,31905,25785,6120
11/2/2016 23:00,41593,6741,0,4712,30140,24147,5993
11/3/2016 0:00,38255,6158,0,4712,27384,23303,4081
11/3/2016 1:00,35495,5310,0,4712,25473,22780,2693
11/3/2016 2:00,33511,4703,0,4712,24096,22702,1394
11/3/2016 3:00,32183,4179,0,4712,23292,22811,481
11/3/2016 4:00,31427,3896,0,4712,22820,24822,-2002
11/3/2016 5:00,31524,3802,0,4712,23010,27238,-4228
11/3/2016 6:00,33296,5089,0,4712,23495,28153,-4658
11/3/2016 7:00,36668,4885,0,4712,27071,27770,-699
11/3/2016 8:00,38213,5053,299,4712,28149,28512,-363
11/3/2016 9:00,38203,5382,344,4712,27765,30033,-2268
11/3/2016 10:00,39388,5312,400,4712,28963,32058,-3095
11/3/2016 11:00,40918,4378,435,4712,31393,33384,-1991
11/3/2016 12:00,42145,3761,459,4712,33213,34003,-790
11/3/2016 13:00,43225,3167,456,4712,34889,35274,-385
11/3/2016 14:00,44146,2819,431,4712,36185,34790,1395
11/3/2016 15:00,44641,3078,367,4712,36484,34607,1877
11/3/2016 16:00,44607,3218,296,4712,36380,33577,2803
11/3/2016 17:00,44463,3535,249,4712,35967,33777,2190
11/3/2016 18:00,43563,2987,0,4712,35865,34228,1637
11/3/2016 19:00,43317,2696,0,4712,35909,33346,2563
11/3/2016 20:00,43564,2604,0,4712,36248,31792,4456
11/3/2016 21:00,42601,2823,0,4712,35067,28883,6184
11/3/2016 22:00,40695,3191,0,4712,32792,26483,6309
11/3/2016 23:00,37918,2563,0,4712,30642,25200,5442
11/4/2016 0:00,34763,2415,0,4712,27636,24162,3474
11/4/2016 1:00,32444,2083,0,4712,25648,23324,2324
11/4/2016 2:00,30850,2028,0,4712,24110,23268,842
11/4/2016 3:00,29942,1699,0,4712,23531,23774,-243
11/4/2016 4:00,29475,1686,0,4712,23076,25440,-2364
11/4/2016 5:00,29720,1957,0,4712,23051,27554,-4503
11/4/2016 6:00,31453,1928,0,4712,24814,28955,-4141
11/4/2016 7:00,34764,1929,0,4712,28123,29056,-933
11/4/2016 8:00,36655,1657,145,4712,30141,30123,18
11/4/2016 9:00,36657,1194,202,4712,30548,31490,-942
11/4/2016 10:00,37643,1013,247,4712,31671,32367,-696
11/4/2016 11:00,39049,1009,318,4712,33011,33232,-221
11/4/2016 12:00,40177,856,389,4712,34220,33841,379
11/4/2016 13:00,41083,866,400,4712,35105,34076,1029
11/4/2016 14:00,41851,1031,393,4712,35715,33957,1758
11/4/2016 15:00,42163,1378,305,4712,35769,33635,2134
11/4/2016 16:00,42087,1310,275,4712,35790,32975,2815
11/4/2016 17:00,41877,1668,152,4712,35345,32976,2369
11/4/2016 18:00,41170,1411,0,4712,35048,33022,2026
11/4/2016 19:00,41012,1277,0,4712,35022,32145,2877
11/4/2016 20:00,41121,1440,0,4712,34969,30978,3991
11/4/2016 21:00,40171,1488,0,4712,33970,29601,4369
11/4/2016 22:00,38808,1143,0,4712,32953,27612,5341
11/4/2016 23:00,36918,1036,0,4712,31170,25714,5456
11/5/2016 0:00,34577,1225,0,4712,28640,24563,4077
11/5/2016 1:00,32358,1157,0,4712,26488,23844,2644
11/5/2016 2:00,30801,1082,0,4712,25007,23196,1811
11/5/2016 3:00,29728,1067,0,4712,23949,23013,936
11/5/2016 4:00,29044,963,0,4712,23369,23275,94
11/5/2016 5:00,28735,1172,0,4712,22851,23982,-1131
11/5/2016 6:00,29069,1046,0,4712,23312,24615,-1303
11/5/2016 7:00,30037,1005,0,4712,24320,25265,-945
11/5/2016 8:00,31136,841,98,4712,25484,26469,-985
11/5/2016 9:00,32038,936,192,4712,26198,27565,-1367
11/5/2016 10:00,33612,1344,247,4712,27310,27869,-559
11/5/2016 11:00,35009,1708,278,4712,28311,28217,94
11/5/2016 12:00,35917,2126,309,4712,28770,28571,199
11/5/2016 13:00,36692,2293,306,4712,29381,28771,610
11/5/2016 14:00,37414,2676,303,4712,29723,28826,897
11/5/2016 15:00,37881,3012,282,4712,29875,28457,1418
11/5/2016 16:00,37997,2796,241,4712,30248,28352,1896
11/5/2016 17:00,37817,2586,205,4712,30315,27882,2433
11/5/2016 18:00,37355,3151,0,4712,29492,27891,1601
11/5/2016 19:00,37282,3403,0,4712,29167,26824,2343
11/5/2016 20:00,37721,4207,0,4712,28802,25171,3631
11/5/2016 21:00,36807,4766,0,4712,27329,23403,3926
11/5/2016 22:00,35479,4818,0,4712,25950,21623,4327
11/5/2016 23:00,33808,4528,0,4712,24568,20494,4074
11/6/2016 0:00,31741,4697,0,4712,22332,19370,2962
11/6/2016 1:00,29846,4722,0,4712,20412,18568,1844
11/6/2016 2:00,27302,4226,0,4712,18364,18200,164
11/6/2016 3:00,26740,4285,0,4712,17743,17888,-145
11/6/2016 4:00,26376,4030,0,4712,17634,18423,-789
11/6/2016 5:00,26342,3117,0,4712,18513,19483,-970
11/6/2016 6:00,26702,3004,0,4712,18986,19588,-602
11/6/2016 7:00,27579,3659,0,4712,19208,20171,-963
11/6/2016 8:00,28678,3242,116,4712,20609,22023,-1414
11/6/2016 9:00,30763,2750,192,4712,23109,24130,-1021
11/6/2016 10:00,32503,2707,234,4712,24850,24957,-107
11/6/2016 11:00,33806,2949,258,4712,25887,25260,627
11/6/2016 12:00,35033,3893,302,4712,26126,26077,49
11/6/2016 13:00,36123,3338,317,4712,27755,26985,770
11/6/2016 14:00,36726,3009,298,4712,28707,27248,1459
11/6/2016 15:00,36747,2913,274,4712,28849,27108,1741
11/6/2016 16:00,36565,2855,224,4712,28775,27165,1610
11/6/2016 17:00,36466,2718,183,4712,28852,27580,1272
11/6/2016 18:00,37122,3145,0,4712,29266,28076,1190
11/6/2016 19:00,38150,3609,0,4712,29829,27502,2327
11/6/2016 20:00,37676,4097,0,4712,28867,25987,2880
11/6/2016 21:00,36472,4938,0,4712,26821,24247,2574
11/6/2016 22:00,34868,5362,0,4712,24793,22392,2401
11/6/2016 23:00,32436,5770,0,4712,21954,20305,1649
11/7/2016 0:00,,5591,0,4712,-10303,19178,-29481
11/7/2016 1:00,28468,5380,0,4712,18376,18441,-65
11/7/2016 2:00,27518,5130,0,4712,17675,18143,-468
11/7/2016 3:00,26978,4645,0,4712,17621,18776,-1155
11/7/2016 4:00,26972,4251,0,4712,18009,19879,-1870
11/7/2016 5:00,27644,3581,0,4712,19351,22678,-3327
11/7/2016 6:00,29774,2157,0,4712,22905,26330,-3425
11/7/2016 7:00,33204,1942,0,4712,26550,26898,-348
11/7/2016 8:00,34351,1735,64,4712,27840,27959,-119
11/7/2016 9:00,35296,1063,79,4712,29442,28872,570
11/7/2016 10:00,36496,905,123,4712,30756,29601,1155
11/7/2016 11:00,37503,568,157,4712,32065,30360,1705
11/7/2016 12:00,38402,792,109,4712,32789,31046,1743
11/7/2016 13:00,38974,1215,67,4712,32980,31394,1586
11/7/2016 14:00,39591,1110,35,4712,33733,31636,2097
11/7/2016 15:00,39823,1142,23,4712,33946,31040,2906
11/7/2016 16:00,39738,1700,25,4712,33301,30768,2533
11/7/2016 17:00,39742,2310,1,4712,32719,30554,2165
11/7/2016 18:00,39991,3048,0,4712,32231,30969,1262
11/7/2016 19:00,40694,3515,0,4712,32467,29811,2656
11/7/2016 20:00,40039,4193,0,4712,31134,28174,2960
11/7/2016 21:00,38864,4260,0,4712,29892,27095,2797
11/7/2016 22:00,36826,3632,0,4712,28482,25290,3192
11/7/2016 23:00,33862,3149,0,4712,26001,23530,2471
11/8/2016 0:00,31151,3698,0,4712,22741,21438,1303
11/8/2016 1:00,29300,3761,0,4712,20827,20032,795
11/8/2016 2:00,28204,4100,0,4712,19392,18872,520
11/8/2016 3:00,27536,4480,0,4712,18343,18441,-98
11/8/2016 4:00,27267,4619,0,4712,17935,18704,-769
11/8/2016 5:00,27731,5078,0,4712,17941,19789,-1848
11/8/2016 6:00,29827,6321,0,4712,18793,22134,-3341
11/8/2016 7:00,33376,7179,0,4712,21484,22094,-610
11/8/2016 8:00,34388,7962,1,4712,21712,22631,-919
11/8/2016 9:00,34872,7476,18,4712,22667,22985,-318
11/8/2016 10:00,35656,7857,54,4712,23033,24227,-1194
11/8/2016 11:00,36218,7436,73,4712,23996,24188,-192
11/8/2016 12:00,36492,7350,122,4712,24309,24340,-31
11/8/2016 13:00,36599,7277,102,4712,24509,24191,318
11/8/2016 14:00,36527,7611,145,4712,24059,24373,-314
11/8/2016 15:00,36397,6780,108,4712,24797,24522,275
11/8/2016 16:00,36133,6687,65,4712,24668,24846,-178
11/8/2016 17:00,36395,5787,17,4712,25880,26824,-944
11/8/2016 18:00,37460,4767,0,4712,27981,27427,554
11/8/2016 19:00,38326,5194,0,4712,28420,26572,1848
11/8/2016 20:00,37753,5643,0,4712,27398,25506,1892
11/8/2016 21:00,36779,5513,0,4712,26554,24419,2135
11/8/2016 22:00,34996,5419,0,4712,24865,22761,2104
11/8/2016 23:00,32695,5608,0,4712,22375,20947,1428
11/9/2016 0:00,30578,5599,0,4712,20267,19249,1018
11/9/2016 1:00,28885,5646,0,4712,18527,18254,273
11/9/2016 2:00,27736,5387,0,4712,17636,17897,-261
11/9/2016 3:00,27018,5078,0,4712,17227,18165,-938
11/9/2016 4:00,26681,4275,0,4712,17694,19254,-1560
11/9/2016 5:00,27153,3915,0,4712,18526,21294,-2768
11/9/2016 6:00,29081,3905,0,4712,20465,23926,-3461
11/9/2016 7:00,32461,3941,0,4712,23808,24345,-537
11/9/2016 8:00,33448,3792,79,4712,24865,25103,-238
11/9/2016 9:00,33971,3312,136,4712,25811,25891,-80
11/9/2016 10:00,34671,3184,159,4712,26616,26607,9
11/9/2016 11:00,35236,3423,171,4712,26930,26693,237
11/9/2016 12:00,35654,3429,187,4712,27326,26968,358
11/9/2016 13:00,35818,3109,188,4712,27809,27246,563
11/9/2016 14:00,35937,3117,166,4712,27942,26958,984
11/9/2016 15:00,35895,2887,176,4712,28120,27036,1084
11/9/2016 16:00,35731,2688,143,4712,28187,27103,1084
11/9/2016 17:00,35893,2395,75,4712,28711,28417,294
11/9/2016 18:00,36896,2056,0,4712,30128,29538,590
11/9/2016 19:00,37890,1900,0,4712,31278,28882,2396
11/9/2016 20:00,37299,1937,0,4712,30650,28051,2599
11/9/2016 21:00,36232,1736,0,4712,29785,26580,3205
11/9/2016 22:00,34441,2122,0,4712,27607,23846,3761
11/9/2016 23:00,31935,2289,0,4712,24933,21967,2966
11/10/2016 0:00,29398,2401,0,4712,22285,20405,1880
11/10/2016 1:00,27680,2446,0,4712,20522,19761,761
11/10/2016 2:00,26755,2275,0,4712,19767,19315,452
11/10/2016 3:00,26240,2478,0,4712,19050,18703,347
11/10/2016 4:00,26113,2665,0,4712,18735,18907,-172
11/10/2016 5:00,26562,2817,0,4712,19033,20530,-1497
11/10/2016 6:00,28593,2759,0,4712,21121,23871,-2750
11/10/2016 7:00,31980,2327,0,4712,24940,24785,155
11/10/2016 8:00,32797,2184,65,4712,25836,25222,614
11/10/2016 9:00,33322,1691,133,4712,26786,25930,856
11/10/2016 10:00,34014,1510,170,4712,27622,26182,1440
11/10/2016 11:00,34607,1666,224,4712,28004,26208,1796
11/10/2016 12:00,35120,2183,231,4712,27994,26002,1992
11/10/2016 13:00,35408,2307,207,4712,28183,26246,1937
11/10/2016 14:00,35760,2213,129,4712,28705,26435,2270
11/10/2016 15:00,35716,1983,88,4712,28933,26499,2434
11/10/2016 16:00,35507,1981,72,4712,28742,26276,2466
11/10/2016 17:00,35381,2299,30,4712,28340,26748,1592
11/10/2016 18:00,36145,2277,0,4712,29157,27350,1807
11/10/2016 19:00,37107,2840,0,4712,29554,26482,3072
11/10/2016 20:00,36489,3399,0,4712,28378,25570,2808
11/10/2016 21:00,35577,3593,0,4712,27272,24197,3075
11/10/2016 22:00,33955,4079,0,4712,25164,22126,3038
11/10/2016 23:00,31575,4070,0,4712,22792,20336,2456
11/11/2016 0:00,29221,4157,0,4712,20352,18561,1791
11/11/2016 1:00,27532,3975,0,4712,18845,17879,966
11/11/2016 2:00,26532,3909,0,4712,17911,17398,513
11/11/2016 3:00,25978,3701,0,4712,17566,17558,8
11/11/2016 4:00,25853,3392,0,4712,17749,18115,-366
11/11/2016 5:00,26370,3600,0,4712,18058,19744,-1686
11/11/2016 6:00,28233,3572,0,4712,19948,22722,-2774
11/11/2016 7:00,31440,3774,0,4712,22953,23240,-287
11/11/2016 8:00,32457,3835,11,4712,23899,24256,-357
11/11/2016 9:00,33084,2787,88,4712,25498,25230,268
11/11/2016 10:00,33864,2393,181,4712,26578,25789,789
11/11/2016 11:00,34517,2055,248,4712,27502,26238,1264
11/11/2016 12:00,34998,1898,298,4712,28089,26881,1208
11/11/2016 13:00,35338,1539,227,4712,28861,27534,1327
11/11/2016 14:00,35861,1527,223,4712,29399,27817,1582
11/11/2016 15:00,36141,1543,159,4712,29728,27807,1921
11/11/2016 16:00,36204,1679,137,4712,29676,27612,2064
11/11/2016 17:00,35979,1900,71,4712,29295,27627,1668
11/11/2016 18:00,36150,2395,0,4712,29042,27471,1571
11/11/2016 19:00,36720,3236,0,4712,28772,26066,2706
11/11/2016 20:00,35573,3424,0,4712,27437,25217,2220
11/11/2016 21:00,34586,3393,0,4712,26481,23712,2769
11/11/2016 22:00,33288,3792,0,4712,24784,21674,3110
11/11/2016 23:00,31676,4498,0,4712,22466,19407,3059
11/12/2016 0:00,29562,4174,0,4712,20676,18495,2181
11/12/2016 1:00,27959,4183,0,4712,19065,17384,1681
11/12/2016 2:00,26808,4130,0,4712,17966,16976,990
11/12/2016 3:00,26202,4060,0,4712,17429,16873,556
11/12/2016 4:00,25868,3733,0,4712,17423,16917,506
11/12/2016 5:00,25853,3798,0,4712,17343,17716,-373
11/12/2016 6:00,26461,3393,0,4712,18356,18691,-335
11/12/2016 7:00,27658,3301,0,4712,19645,19927,-282
11/12/2016 8:00,28645,2814,65,4712,21054,22457,-1403
11/12/2016 9:00,30506,1719,187,4712,23888,24166,-278
11/12/2016 10:00,31924,1015,223,4712,25974,25074,900
11/12/2016 11:00,33012,760,276,4712,27264,25706,1558
11/12/2016 12:00,33777,754,292,4712,28020,26124,1896
11/12/2016 13:00,34311,713,243,4712,28643,26372,2271
11/12/2016 14:00,34651,628,184,4712,29127,26505,2622
11/12/2016 15:00,34714,456,166,4712,29380,26590,2790
11/12/2016 16:00,34453,290,113,4712,29338,26574,2764
11/12/2016 17:00,34181,278,34,4712,29156,27014,2142
11/12/2016 18:00,34769,627,0,4712,29430,27352,2078
11/12/2016 19:00,35500,893,0,4712,29895,26504,3391
11/12/2016 20:00,34678,1312,0,4712,28654,25426,3228
11/12/2016 21:00,33816,1585,0,4712,27519,24135,3384
11/12/2016 22:00,32607,2231,0,4712,25664,22274,3390
11/12/2016 23:00,31129,2677,0,4712,23740,20906,2834
11/13/2016 0:00,29398,2918,0,4712,21768,19262,2506
11/13/2016 1:00,27839,2920,0,4712,20207,18452,1755
11/13/2016 2:00,26790,3033,0,4712,19045,17379,1666
11/13/2016 3:00,26075,3406,0,4712,17958,16572,1386
11/13/2016 4:00,25644,3901,0,4712,17032,16080,952
11/13/2016 5:00,25562,4146,0,4712,16704,16139,565
11/13/2016 6:00,25926,4613,0,4712,16601,16394,207
11/13/2016 7:00,26673,5125,0,4712,16836,17044,-208
11/13/2016 8:00,27397,5398,101,4712,17187,18275,-1088
11/13/2016 9:00,29014,4055,186,4712,20061,19988,73
11/13/2016 10:00,30350,4558,198,4712,20882,19770,1112
11/13/2016 11:00,31150,5465,240,4712,20733,20040,693
11/13/2016 12:00,31644,5110,253,4712,21569,20830,739
11/13/2016 13:00,32099,4828,235,4712,22324,21401,923
11/13/2016 14:00,32526,4674,206,4712,22933,21882,1051
11/13/2016 15:00,32851,4379,137,4712,23623,22110,1513
11/13/2016 16:00,33099,4199,122,4712,24067,22792,1275
11/13/2016 17:00,33244,3290,55,4712,25187,24195,992
11/13/2016 18:00,34258,3606,0,4712,25940,24105,1835
11/13/2016 19:00,35499,4869,0,4712,25918,23626,2292
11/13/2016 20:00,35417,5091,0,4712,25613,22489,3124
11/13/2016 21:00,34365,5492,0,4712,24162,20480,3682
11/13/2016 22:00,32863,6751,0,4712,21401,17194,4207
11/13/2016 23:00,30643,8065,0,4712,17866,14743,3123
11/14/2016 0:00,28401,7732,0,4712,15957,14099,1858
11/14/2016 1:00,26835,7631,0,4712,14492,13512,980
11/14/2016 2:00,25942,7516,0,4712,13713,13797,-84
11/14/2016 3:00,25542,6837,0,4712,13992,14166,-174
11/14/2016 4:00,25496,6228,0,4712,14556,15295,-739
11/14/2016 5:00,26109,5665,0,4712,15733,17387,-1654
11/14/2016 6:00,28115,5192,0,4712,18211,20465,-2254
11/14/2016 7:00,31503,4781,0,4712,22010,21969,41
11/14/2016 8:00,32390,3828,7,4712,23844,23738,106
11/14/2016 9:00,32925,1895,48,4712,26270,25534,736
11/14/2016 10:00,33941,1003,80,4712,28146,26849,1297
11/14/2016 11:00,35072,761,92,4712,29507,27950,1557
11/14/2016 12:00,36087,647,79,4712,30648,28593,2055
11/14/2016 13:00,36967,593,99,4712,31563,29228,2335
11/14/2016 14:00,37935,674,120,4712,32428,29592,2836
11/14/2016 15:00,38670,702,117,4712,33139,29923,3216
11/14/2016 16:00,39072,601,119,4712,33640,30159,3481
11/14/2016 17:00,39043,354,96,4712,33881,30217,3664
11/14/2016 18:00,39026,432,0,4712,33882,30494,3388
11/14/2016 19:00,39659,641,0,4712,34306,29775,4531
11/14/2016 20:00,38760,951,0,4712,33097,28603,4494
11/14/2016 21:00,37418,1323,0,4712,31382,26462,4920
11/14/2016 22:00,35418,1985,0,4712,28721,23409,5312
11/14/2016 23:00,32584,2869,0,4712,25003,20244,4759
11/15/2016 0:00,29868,3556,0,4712,21600,18032,3568
11/15/2016 1:00,28053,4082,0,4712,19260,16625,2635
11/15/2016 2:00,26998,4289,0,4712,17997,16002,1995
11/15/2016 3:00,26408,4338,0,4712,17358,15836,1522
11/15/2016 4:00,26259,4569,0,4712,16978,16321,657
11/15/2016 5:00,26844,4784,0,4712,17348,18033,-685
11/15/2016 6:00,28894,4809,0,4712,19374,21378,-2004
11/15/2016 7:00,32277,4505,0,4712,23060,22480,580
11/15/2016 8:00,33141,3963,38,4712,24428,23212,1216
11/15/2016 9:00,33643,2638,101,4712,26191,25486,705
11/15/2016 10:00,34667,1201,172,4712,28583,26974,1609
11/15/2016 11:00,35828,1048,159,4712,29910,28030,1880
11/15/2016 12:00,37087,1149,136,4712,31090,28729,2361
11/15/2016 13:00,38373,1291,113,4712,32256,29777,2479
11/15/2016 14:00,39764,1139,90,4712,33822,30845,2977
11/15/2016 15:00,40811,1086,78,4712,34935,31230,3705
11/15/2016 16:00,41248,949,52,4712,35535,30921,4614
11/15/2016 17:00,40967,887,37,4712,35330,30319,5011
11/15/2016 18:00,40275,1606,0,4712,33957,30063,3894
11/15/2016 19:00,40354,2463,0,4712,33179,28350,4829
11/15/2016 20:00,39023,3157,0,4712,31154,26628,4526
11/15/2016 21:00,37506,3833,0,4712,28960,23958,5002
11/15/2016 22:00,35395,4706,0,4712,25977,20793,5184
11/15/2016 23:00,32587,5258,0,4712,22617,17649,4968
11/16/2016 0:00,29836,6258,0,4712,18866,15492,3374
11/16/2016 1:00,27885,7318,0,4712,15855,13964,1891
11/16/2016 2:00,26876,8026,0,4712,14138,13215,923
11/16/2016 3:00,26247,8209,0,4712,13325,13083,242
11/16/2016 4:00,26061,8246,0,4712,13103,14022,-919
11/16/2016 5:00,26686,8149,0,4712,13825,15976,-2151
11/16/2016 6:00,28691,8018,0,4712,15961,19054,-3093
11/16/2016 7:00,32111,7771,0,4712,19629,19695,-66
11/16/2016 8:00,32956,7728,43,4712,20473,20682,-209
11/16/2016 9:00,33543,6228,91,4712,22512,22612,-100
11/16/2016 10:00,34691,5179,141,4712,24659,23940,719
11/16/2016 11:00,36001,5439,197,4712,25653,24426,1227
11/16/2016 12:00,37367,6357,214,4712,26085,24618,1467
11/16/2016 13:00,38779,7665,212,4712,26191,24527,1664
11/16/2016 14:00,40259,9099,189,4712,26259,24583,1676
11/16/2016 15:00,41367,10506,188,4712,25961,24705,1256
11/16/2016 16:00,41839,10808,169,4712,26151,24611,1540
11/16/2016 17:00,41501,9910,112,4712,26767,24181,2586
11/16/2016 18:00,40966,11153,0,4712,25100,23006,2094
11/16/2016 19:00,41294,12773,0,4712,23809,20463,3346
11/16/2016 20:00,40121,13951,0,4712,21457,18866,2591
11/16/2016 21:00,38765,13941,0,4712,20112,17087,3025
11/16/2016 22:00,36704,13840,0,4712,18152,14772,3380
11/16/2016 23:00,33800,13601,0,4712,15487,12334,3153
11/17/2016 0:00,30886,12621,0,4712,13553,10698,2855
11/17/2016 1:00,28777,12770,0,4712,11296,10129,1167
11/17/2016 2:00,27636,12427,0,4712,10497,10048,449
11/17/2016 3:00,26895,11478,0,4712,10705,10132,573
11/17/2016 4:00,26683,11556,0,4712,10415,10256,159
11/17/2016 5:00,27193,12461,0,4712,10020,11186,-1166
11/17/2016 6:00,29215,12900,0,4712,11603,13624,-2021
11/17/2016 7:00,32660,13828,0,4712,14120,14308,-188
11/17/2016 8:00,33627,13754,142,4712,15020,15640,-620
11/17/2016 9:00,34468,12949,248,4712,16559,16832,-273
11/17/2016 10:00,35727,13435,258,4712,17323,17828,-505
11/17/2016 11:00,37021,13515,291,4712,18503,18504,-1
11/17/2016 12:00,38130,13712,359,4712,19346,19342,4
11/17/2016 13:00,39247,13404,355,4712,20775,20221,554
11/17/2016 14:00,40479,13135,359,4712,22273,20883,1390
11/17/2016 15:00,41130,13128,298,4712,22992,21303,1689
11/17/2016 16:00,41244,12794,236,4712,23501,21164,2337
11/17/2016 17:00,40931,13181,206,4712,22832,21083,1749
11/17/2016 18:00,40889,13423,0,4712,22754,21196,1558
11/17/2016 19:00,41670,14030,0,4712,22928,20245,2683
11/17/2016 20:00,41037,14070,0,4712,22255,19294,2961
11/17/2016 21:00,40016,13739,0,4712,21564,18483,3081
11/17/2016 22:00,38365,13409,0,4712,20243,16871,3372
11/17/2016 23:00,35634,12649,0,4712,18273,14952,3321
11/18/2016 0:00,32948,11954,0,4712,16282,14732,1550
11/18/2016 1:00,30947,10136,0,4712,16099,14863,1236
11/18/2016 2:00,29667,8926,0,4712,16029,14549,1480
11/18/2016 3:00,28965,9301,0,4712,14952,13606,1346
11/18/2016 4:00,28663,10366,0,4712,13585,12924,661
11/18/2016 5:00,29037,10869,0,4712,13456,14306,-850
11/18/2016 6:00,30919,11643,0,4712,14564,16763,-2199
11/18/2016 7:00,34092,11594,0,4712,17786,17676,110
11/18/2016 8:00,34974,11444,189,4712,18628,18419,209
11/18/2016 9:00,35675,11827,331,4712,18805,18914,-109
11/18/2016 10:00,36874,11721,380,4712,20061,20101,-40
11/18/2016 11:00,37939,11130,400,4712,21697,21238,459
11/18/2016 12:00,38376,10121,415,4712,23128,21997,1131
11/18/2016 13:00,38714,9192,396,4712,24414,22404,2010
11/18/2016 14:00,38813,9349,380,4712,24371,21983,2388
11/18/2016 15:00,38326,10164,329,4712,23121,20078,3043
11/18/2016 16:00,37334,10840,278,4712,21505,19878,1627
11/18/2016 17:00,36333,9539,166,4712,21916,21655,261
11/18/2016 18:00,36336,7571,0,4712,24053,22423,1630
11/18/2016 19:00,36688,8197,0,4712,23779,20806,2973
11/18/2016 20:00,35704,9622,0,4712,21370,19302,2068
11/18/2016 21:00,34787,9974,0,4712,20101,18009,2092
11/18/2016 22:00,33527,9660,0,4712,19154,16376,2778
11/18/2016 23:00,31892,9496,0,4712,17683,15314,2369
11/19/2016 0:00,30060,8407,0,4712,16941,15822,1119
11/19/2016 1:00,28618,7214,0,4712,16692,16045,647
11/19/2016 2:00,27701,5928,0,4712,17061,16493,568
11/19/2016 3:00,27211,5313,0,4712,17186,16661,525
11/19/2016 4:00,27115,4775,0,4712,17628,17536,92
11/19/2016 5:00,27445,4063,0,4712,18670,18300,370
11/19/2016 6:00,28444,3841,0,4712,19891,19613,278
11/19/2016 7:00,30009,3787,0,4712,21510,20543,967
11/19/2016 8:00,31415,3841,202,4712,22660,21512,1148
11/19/2016 9:00,33074,3552,346,4712,24464,22040,2424
11/19/2016 10:00,33932,3796,349,4712,25075,22345,2730
11/19/2016 11:00,33887,3507,371,4712,25297,22079,3218
11/19/2016 12:00,33421,3289,387,4712,25032,21326,3706
11/19/2016 13:00,32754,3388,383,4712,24270,20757,3513
11/19/2016 14:00,32206,3247,345,4712,23902,20589,3313
11/19/2016 15:00,31683,3215,289,4712,23468,20634,2834
11/19/2016 16:00,31478,3134,238,4712,23393,20950,2443
11/19/2016 17:00,31564,2984,138,4712,23731,21970,1761
11/19/2016 18:00,32881,3432,0,4712,24737,22914,1823
11/19/2016 19:00,34535,4644,0,4712,25179,21862,3317
11/19/2016 20:00,34532,5649,0,4712,24170,20696,3474
11/19/2016 21:00,34339,7241,0,4712,22386,19051,3335
11/19/2016 22:00,33775,8799,0,4712,20265,17085,3180
11/19/2016 23:00,32827,10276,0,4712,17839,15093,2746
11/20/2016 0:00,31718,11255,0,4712,15751,13787,1964
11/20/2016 1:00,30694,11764,0,4712,14218,13171,1047
11/20/2016 2:00,30211,11940,0,4712,13559,13064,495
11/20/2016 3:00,29985,11850,0,4712,13423,13318,105
11/20/2016 4:00,30002,11474,0,4712,13816,13718,98
11/20/2016 5:00,30395,11518,0,4712,14166,14535,-369
11/20/2016 6:00,31269,11397,0,4712,15160,15660,-500
11/20/2016 7:00,32703,11237,0,4712,16753,17261,-508
11/20/2016 8:00,33960,10179,157,4712,18912,19191,-279
11/20/2016 9:00,34938,8022,250,4712,21955,19331,2624
11/20/2016 10:00,34821,7685,307,4712,22116,19206,2910
11/20/2016 11:00,33994,6642,377,4712,22263,19012,3251
11/20/2016 12:00,33063,5943,282,4712,22126,18559,3567
11/20/2016 13:00,32280,5910,278,4712,21381,18386,2995
11/20/2016 14:00,31712,5996,258,4712,20746,18010,2736
11/20/2016 15:00,31259,6144,246,4712,20156,17994,2162
11/20/2016 16:00,31182,5915,199,4712,20356,18294,2062
11/20/2016 17:00,31380,5377,124,4712,21167,19209,1958
11/20/2016 18:00,32859,7233,0,4712,20914,19188,1726
11/20/2016 19:00,34688,8871,0,4712,21105,18280,2825
11/20/2016 20:00,34669,10262,0,4712,19695,16949,2746
11/20/2016 21:00,34195,11363,0,4712,18120,15582,2538
11/20/2016 22:00,33373,11563,0,4712,17098,14203,2895
11/20/2016 23:00,31766,11850,0,4712,15204,12879,2325
11/21/2016 0:00,30064,11563,0,4712,13788,12027,1761
11/21/2016 1:00,28833,11172,0,4712,12949,12021,928
11/21/2016 2:00,28241,10816,0,4712,12714,12186,528
11/21/2016 3:00,28088,10363,0,4712,13014,12869,145
11/21/2016 4:00,28322,9648,0,4712,13962,14403,-441
11/21/2016 5:00,29233,9210,0,4712,15311,17112,-1801
11/21/2016 6:00,31438,8472,0,4712,18254,19752,-1498
11/21/2016 7:00,34276,8250,0,4712,21313,20434,879
11/21/2016 8:00,35498,7724,77,4712,22985,21706,1279
11/21/2016 9:00,35731,5533,216,4712,25270,22838,2432
11/21/2016 10:00,35544,5084,238,4712,25510,22449,3061
11/21/2016 11:00,35340,5111,208,4712,25309,21817,3492
11/21/2016 12:00,35100,5407,275,4712,24706,21212,3494
11/21/2016 13:00,34974,6183,332,4712,23747,20334,3413
11/21/2016 14:00,35137,7232,299,4712,22894,20054,2840
11/21/2016 15:00,35294,7658,255,4712,22668,19915,2753
11/21/2016 16:00,35283,7100,212,4712,23258,20373,2885
11/21/2016 17:00,35182,7355,186,4712,22929,20501,2428
11/21/2016 18:00,36147,8816,0,4712,22618,19851,2767
11/21/2016 19:00,37258,10875,0,4712,21671,18671,3000
11/21/2016 20:00,36620,11672,0,4712,20235,16971,3264
11/21/2016 21:00,35758,12823,0,4712,18223,15278,2945
11/21/2016 22:00,34382,13069,0,4712,16602,13138,3464
11/21/2016 23:00,32257,13302,0,4712,14243,11301,2942
11/22/2016 0:00,29933,13093,0,4712,12128,10221,1907
11/22/2016 1:00,28246,13133,0,4712,10402,10112,290
11/22/2016 2:00,27256,12439,0,4712,10105,10188,-83
11/22/2016 3:00,26676,12012,0,4712,9952,10223,-271
11/22/2016 4:00,26479,11688,0,4712,10079,11741,-1662
11/22/2016 5:00,26986,9735,0,4712,12539,13726,-1187
11/22/2016 6:00,28557,8778,0,4712,15067,15979,-912
11/22/2016 7:00,31035,8128,0,4712,18194,17543,651
11/22/2016 8:00,32377,7599,203,4712,19862,18495,1367
11/22/2016 9:00,33669,7310,296,4712,21351,19493,1858
11/22/2016 10:00,35040,7988,347,4712,21992,19747,2245
11/22/2016 11:00,36140,8651,372,4712,22404,20026,2378
11/22/2016 12:00,36800,9468,391,4712,22228,19557,2671
11/22/2016 13:00,37333,10273,380,4712,21968,18943,3025
11/22/2016 14:00,37818,11597,360,4712,21149,18591,2558
11/22/2016 15:00,37953,12084,302,4712,20854,18664,2190
11/22/2016 16:00,37805,11658,238,4712,21197,19517,1680
11/22/2016 17:00,37517,9452,128,4712,23225,21729,1496
11/22/2016 18:00,38330,8663,0,4712,24954,22145,2809
11/22/2016 19:00,39163,8822,0,4712,25629,21708,3921
11/22/2016 20:00,38585,8904,0,4712,24970,20889,4081
11/22/2016 21:00,37716,9266,0,4712,23738,18773,4965
11/22/2016 22:00,36514,10514,0,4712,21289,16765,4524
11/22/2016 23:00,34479,10044,0,4712,19723,15554,4169
11/23/2016 0:00,32038,9521,0,4712,17805,14285,3520
11/23/2016 1:00,30001,9735,0,4712,15554,13518,2036
11/23/2016 2:00,28661,9185,0,4712,14764,13402,1362
11/23/2016 3:00,27899,8815,0,4712,14372,12889,1483
11/23/2016 4:00,27611,9132,0,4712,13767,13444,323
11/23/2016 5:00,27912,8551,0,4712,14649,15064,-415
11/23/2016 6:00,29377,8430,0,4712,16235,16912,-677
11/23/2016 7:00,31591,8277,0,4712,18601,18379,222
11/23/2016 8:00,32816,7018,105,4712,20981,20588,393
11/23/2016 9:00,34082,4818,226,4712,24326,21734,2592
11/23/2016 10:00,35052,4416,223,4712,25701,23461,2240
11/23/2016 11:00,35617,2199,228,4712,28477,25120,3357
11/23/2016 12:00,36025,1861,216,4712,29236,25402,3834
11/23/2016 13:00,36168,1331,220,4712,29906,25689,4217
11/23/2016 14:00,36382,1134,216,4712,30321,25751,4570
11/23/2016 15:00,36549,1813,131,4712,29893,25502,4391
11/23/2016 16:00,36452,1640,76,4712,30025,25584,4441
11/23/2016 17:00,36032,1179,7,4712,30134,25925,4209
11/23/2016 18:00,36337,1248,0,4712,30377,26221,4156
11/23/2016 19:00,36912,1625,0,4712,30575,25262,5313
11/23/2016 20:00,36100,2071,0,4712,29318,23728,5590
11/23/2016 21:00,35281,3225,0,4712,27343,22184,5159
11/23/2016 22:00,34103,3794,0,4712,25597,20383,5214
11/23/2016 23:00,32524,3980,0,4712,23832,18343,5489
11/24/2016 0:00,30507,4668,0,4712,21127,16504,4623
11/24/2016 1:00,28793,5428,0,4712,18653,15437,3216
11/24/2016 2:00,27677,6059,0,4712,16906,14526,2380
11/24/2016 3:00,26985,6742,0,4712,15531,14282,1249
11/24/2016 4:00,26795,6957,0,4712,15126,14151,975
11/24/2016 5:00,27043,7642,0,4712,14689,14218,471
11/24/2016 6:00,27945,8644,0,4712,14590,14897,-307
11/24/2016 7:00,29291,8843,0,4712,15735,15456,279
11/24/2016 8:00,30428,9239,84,4712,16393,17326,-933
11/24/2016 9:00,32080,7492,174,4712,19702,19949,-247
11/24/2016 10:00,33352,6047,187,4712,22405,20580,1825
11/24/2016 11:00,34221,6221,198,4712,23090,21287,1803
11/24/2016 12:00,34501,5151,217,4712,24421,21464,2957
11/24/2016 13:00,34157,4509,209,4712,24727,21618,3109
11/24/2016 14:00,33626,3866,186,4712,24861,21603,3258
11/24/2016 15:00,33195,3647,183,4712,24653,21160,3493
11/24/2016 16:00,32688,3691,160,4712,24125,20753,3372
11/24/2016 17:00,31858,3443,108,4712,23596,20654,2942
11/24/2016 18:00,31832,3603,0,4712,23517,20803,2714
11/24/2016 19:00,32136,4272,0,4712,23152,19989,3163
11/24/2016 20:00,31677,4833,0,4712,22132,19116,3016
11/24/2016 21:00,31223,5295,0,4712,21216,18056,3160
11/24/2016 22:00,30570,6170,0,4712,19687,16856,2831
11/24/2016 23:00,29518,6270,0,4712,18536,15818,2718
11/25/2016 0:00,28154,6436,0,4712,17006,14343,2663
11/25/2016 1:00,26999,7665,0,4712,14622,12669,1953
11/25/2016 2:00,26167,8828,0,4712,12628,11879,749
11/25/2016 3:00,25668,9298,0,4712,11658,11386,272
11/25/2016 4:00,25499,9377,0,4712,11411,11843,-432
11/25/2016 5:00,25827,9108,0,4712,12007,12921,-914
11/25/2016 6:00,26652,8394,0,4712,13546,14655,-1109
11/25/2016 7:00,27894,7660,0,4712,15522,16152,-630
11/25/2016 8:00,28574,6972,57,4712,16832,17912,-1080
11/25/2016 9:00,29941,5102,145,4712,19982,19901,81
11/25/2016 10:00,31332,3949,206,4712,22464,21743,721
11/25/2016 11:00,32397,2536,198,4712,24951,23195,1756
11/25/2016 12:00,32872,1763,192,4712,26205,24018,2187
11/25/2016 13:00,32960,1501,202,4712,26546,24188,2358
11/25/2016 14:00,32916,1198,197,4712,26809,24378,2431
11/25/2016 15:00,32773,1387,164,4712,26509,24131,2378
11/25/2016 16:00,32734,1573,159,4712,26289,23650,2639
11/25/2016 17:00,32717,1683,93,4712,26229,24826,1403
11/25/2016 18:00,33814,1492,0,4712,27611,25530,2081
11/25/2016 19:00,34724,1954,0,4712,28059,24559,3500
11/25/2016 20:00,34217,2000,0,4712,27505,23525,3980
11/25/2016 21:00,33612,2511,0,4712,26388,22574,3814
11/25/2016 22:00,32709,2451,0,4712,25546,21016,4530
11/25/2016 23:00,31394,2834,0,4712,23847,19441,4406
11/26/2016 0:00,29695,3315,0,4712,21668,17860,3808
11/26/2016 1:00,28229,3089,0,4712,20428,17639,2789
11/26/2016 2:00,27274,2534,0,4712,20028,17223,2805
11/26/2016 3:00,26569,2558,0,4712,19299,17025,2274
11/26/2016 4:00,26321,2624,0,4712,18985,17120,1865
11/26/2016 5:00,26410,2668,0,4712,19030,17684,1346
11/26/2016 6:00,27013,2425,0,4712,19877,18795,1082
11/26/2016 7:00,28045,2450,0,4712,20883,19605,1278
11/26/2016 8:00,28890,2353,1,4712,21823,21484,339
11/26/2016 9:00,30372,1883,21,4712,23756,23017,739
11/26/2016 10:00,31735,1838,73,4712,25112,23556,1556
11/26/2016 11:00,32466,1943,120,4712,25691,23214,2477
11/26/2016 12:00,32781,2267,161,4712,25641,22949,2692
11/26/2016 13:00,32820,2690,167,4712,25250,22433,2817
11/26/2016 14:00,32604,2904,151,4712,24837,21424,3413
11/26/2016 15:00,32291,3678,151,4712,23750,20910,2840
11/26/2016 16:00,32076,3906,98,4712,23360,20505,2855
11/26/2016 17:00,32077,4447,83,4712,22836,21283,1553
11/26/2016 18:00,33421,4912,0,4712,23797,22089,1708
11/26/2016 19:00,34520,5546,0,4712,24262,20684,3578
11/26/2016 20:00,34035,6733,0,4712,22590,19572,3018
11/26/2016 21:00,33387,7568,0,4712,21107,18219,2888
11/26/2016 22:00,32491,8764,0,4712,19015,16037,2978
11/26/2016 23:00,31116,10240,0,4712,16164,13933,2231
11/27/2016 0:00,29543,10594,0,4712,14237,12205,2032
11/27/2016 1:00,28036,10762,0,4712,12561,11136,1425
11/27/2016 2:00,27036,11081,0,4712,11243,10851,392
11/27/2016 3:00,26368,10567,0,4712,11089,10846,243
11/27/2016 4:00,26017,10289,0,4712,11017,10873,144
11/27/2016 5:00,26012,10549,0,4712,10751,10950,-199
11/27/2016 6:00,26420,11069,0,4712,10640,10939,-299
11/27/2016 7:00,27245,12019,0,4712,10514,10957,-443
11/27/2016 8:00,27951,12639,2,4712,10598,12037,-1439
11/27/2016 9:00,29459,12597,30,4712,12121,12847,-726
11/27/2016 10:00,30968,13796,31,4712,12429,12410,19
11/27/2016 11:00,31966,14744,40,4712,12469,12521,-52
11/27/2016 12:00,32646,14919,74,4712,12941,13023,-82
11/27/2016 13:00,33146,14900,54,4712,13480,13534,-54
11/27/2016 14:00,33535,14872,49,4712,13902,14024,-122
11/27/2016 15:00,33678,14502,18,4712,14446,14546,-100
11/27/2016 16:00,33788,13845,8,4712,15223,15376,-153
11/27/2016 17:00,34119,13511,1,4712,15895,16772,-877
11/27/2016 18:00,35835,13899,0,4712,17224,17690,-466
11/27/2016 19:00,37281,13941,0,4712,18629,17758,871
11/27/2016 20:00,37120,13304,0,4712,19105,17638,1467
11/27/2016 21:00,36164,12491,0,4712,18961,16969,1992
11/27/2016 22:00,34796,12522,0,4712,17562,14994,2568
11/27/2016 23:00,32621,12239,0,4712,15670,13818,1852
11/28/2016 0:00,30391,11111,0,4712,14569,12817,1752
11/28/2016 1:00,28658,10324,0,4712,13622,12471,1151
11/28/2016 2:00,27788,10195,0,4712,12881,12681,200
11/28/2016 3:00,27356,9772,0,4712,12873,12715,158
11/28/2016 4:00,27346,9540,0,4712,13095,13353,-258
11/28/2016 5:00,28023,9773,0,4712,13538,15008,-1470
11/28/2016 6:00,30078,9520,0,4712,15846,17808,-1962
11/28/2016 7:00,33524,9831,0,4712,18982,17931,1051
11/28/2016 8:00,34941,11891,0,4712,18338,18322,16
11/28/2016 9:00,35480,10979,7,4712,19782,18518,1264
11/28/2016 10:00,36395,12494,20,4712,19168,18674,494
11/28/2016 11:00,37240,13409,25,4712,19093,19285,-192
11/28/2016 12:00,37944,12964,28,4712,20240,20733,-493
11/28/2016 13:00,38570,11686,30,4712,22142,21555,587
11/28/2016 14:00,39034,11787,26,4712,22509,21521,988
11/28/2016 15:00,39196,11473,18,4712,22993,21902,1091
11/28/2016 16:00,39031,11211,11,4712,23096,22507,589
11/28/2016 17:00,38656,9862,1,4712,24080,23950,130
11/28/2016 18:00,39023,8669,0,4712,25642,25331,311
11/28/2016 19:00,40043,8696,0,4712,26635,24068,2567
11/28/2016 20:00,39186,8448,0,4712,26027,22782,3245
11/28/2016 21:00,38031,8735,0,4712,24584,20914,3670
11/28/2016 22:00,36240,9069,0,4712,22458,18510,3948
11/28/2016 23:00,33644,8880,0,4712,20052,15760,4292
11/29/2016 0:00,30976,9988,0,4712,16276,13428,2848
11/29/2016 1:00,29231,10403,0,4712,14116,12936,1180
11/29/2016 2:00,28285,9936,0,4712,13637,12925,712
11/29/2016 3:00,27671,9183,0,4712,13776,13441,335
11/29/2016 4:00,27642,8785,0,4712,14145,14216,-71
11/29/2016 5:00,28342,9178,0,4712,14452,15712,-1260
11/29/2016 6:00,30525,8702,0,4712,17112,18266,-1154
11/29/2016 7:00,34116,8335,0,4712,21069,19914,1155
11/29/2016 8:00,35283,6765,0,4712,23805,21038,2767
11/29/2016 9:00,35221,5014,6,4712,25489,21455,4034
11/29/2016 10:00,35699,5773,17,4712,25196,21825,3371
11/29/2016 11:00,36502,6243,26,4712,25521,22989,2532
11/29/2016 12:00,37217,5280,34,4712,27190,24036,3154
11/29/2016 13:00,37858,4712,38,4712,28397,24837,3560
11/29/2016 14:00,38546,4565,39,4712,29230,25078,4152
11/29/2016 15:00,38731,4604,33,4712,29383,25056,4327
11/29/2016 16:00,38762,4986,26,4712,29037,25186,3851
11/29/2016 17:00,38719,4764,13,4712,29230,26158,3072
11/29/2016 18:00,39340,4272,0,4712,30357,26725,3632
11/29/2016 19:00,40464,5075,0,4712,30678,25615,5063
11/29/2016 20:00,39768,5538,0,4712,29518,24637,4881
11/29/2016 21:00,38812,5343,0,4712,28757,23106,5651
11/29/2016 22:00,37047,5549,0,4712,26786,21072,5714
11/29/2016 23:00,34346,4882,0,4712,24752,19193,5559
11/30/2016 0:00,31599,6154,0,4712,20733,16764,3969
11/30/2016 1:00,29652,7486,0,4712,17454,15579,1875
11/30/2016 2:00,28551,8035,0,4712,15804,15073,731
11/30/2016 3:00,28002,8196,0,4712,15094,15109,-15
11/30/2016 4:00,27814,7802,0,4712,15300,16167,-867
11/30/2016 5:00,28502,7435,0,4712,16355,18098,-1743
11/30/2016 6:00,30690,6789,0,4712,19190,21063,-1873
11/30/2016 7:00,34459,6145,0,4712,23602,22557,1045
11/30/2016 8:00,35575,5192,1,4712,25670,22870,2800
11/30/2016 9:00,35413,3577,37,4712,27087,23566,3521
11/30/2016 10:00,35437,3467,56,4712,27201,23422,3779
11/30/2016 11:00,35558,3260,85,4712,27500,23355,4145
11/30/2016 12:00,35502,3094,104,4712,27591,23086,4505
11/30/2016 13:00,35321,3267,96,4712,27246,23223,4023
11/30/2016 14:00,35338,3224,79,4712,27323,23309,4014
11/30/2016 15:00,35219,3063,75,4712,27369,23447,3922
11/30/2016 16:00,35079,2964,63,4712,27339,24196,3143
11/30/2016 17:00,35151,2589,14,4712,27836,25836,2000
11/30/2016 18:00,36544,2860,0,4712,28972,26717,2255
11/30/2016 19:00,38486,4113,0,4712,29662,25915,3747
11/30/2016 20:00,38459,4942,0,4712,28805,24623,4182
11/30/2016 21:00,38099,6229,0,4712,27157,23235,3922
11/30/2016 22:00,36944,7147,0,4712,25085,20974,4111
11/30/2016 23:00,34843,7854,0,4712,22276,18578,3698
12/1/2016 0:00,32491,8370,0,4712,19409,16835,2574
12/1/2016 1:00,30989,8961,0,4712,17316,15733,1583
12/1/2016 2:00,30392,9416,0,4712,16265,15457,808
12/1/2016 3:00,30272,9531,0,4712,16029,15796,233
12/1/2016 4:00,30615,9038,0,4712,16865,17045,-180
12/1/2016 5:00,31596,8760,0,4712,18124,19574,-1450
12/1/2016 6:00,34319,8643,0,4712,20964,23287,-2323
12/1/2016 7:00,38728,9077,0,4712,24939,24051,888
12/1/2016 8:00,39642,8734,6,4712,26190,23400,2790
12/1/2016 9:00,38645,6787,80,4712,27066,24215,2851
12/1/2016 10:00,37561,5876,128,4712,26845,23111,3734
12/1/2016 11:00,36682,6939,128,4712,24903,22462,2441
12/1/2016 12:00,35849,6106,122,4712,24908,22199,2709
12/1/2016 13:00,35067,5375,108,4712,24872,22438,2434
12/1/2016 14:00,34666,4858,89,4712,25008,22656,2352
12/1/2016 15:00,34316,4076,80,4712,25449,23073,2376
12/1/2016 16:00,34138,3258,93,4712,26074,23513,2561
12/1/2016 17:00,34283,2837,81,4712,26653,25335,1318
12/1/2016 18:00,35999,2987,0,4712,28300,26083,2217
12/1/2016 19:00,37769,4592,0,4712,28465,24819,3646
12/1/2016 20:00,37823,6158,0,4712,26953,23557,3396
12/1/2016 21:00,37459,6858,0,4712,25889,22468,3421
12/1/2016 22:00,36351,6872,0,4712,24767,20683,4084
12/1/2016 23:00,34234,6991,0,4712,22531,18797,3734
12/2/2016 0:00,31970,7421,0,4712,19837,17140,2697
12/2/2016 1:00,30191,7379,0,4712,18100,16518,1582
12/2/2016 2:00,29269,7214,0,4712,17343,16749,594
12/2/2016 3:00,28872,6506,0,4712,17654,17757,-103
12/2/2016 4:00,28897,5673,0,4712,18512,18483,29
12/2/2016 5:00,29667,5408,0,4712,19547,20595,-1048
12/2/2016 6:00,31876,5307,0,4712,21857,24428,-2571
12/2/2016 7:00,35592,5136,0,4712,25744,25112,632
12/2/2016 8:00,36555,4702,100,4712,27041,25242,1799
12/2/2016 9:00,36389,4363,295,4712,27019,25324,1695
12/2/2016 10:00,36454,4100,299,4712,27343,25218,2125
12/2/2016 11:00,36285,4769,324,4712,26480,24331,2149
12/2/2016 12:00,35915,5335,352,4712,25517,23762,1755
12/2/2016 13:00,35482,5233,342,4712,25196,23664,1532
12/2/2016 14:00,35332,5330,298,4712,24991,23301,1690
12/2/2016 15:00,35079,6135,294,4712,23938,22844,1094
12/2/2016 16:00,34978,5811,244,4712,24211,23390,821
12/2/2016 17:00,35419,5726,148,4712,24834,24858,-24
12/2/2016 18:00,37105,5662,0,4712,26731,25039,1692
12/2/2016 19:00,37701,6055,0,4712,26934,24148,2786
12/2/2016 20:00,37099,6008,0,4712,26379,23381,2998
12/2/2016 21:00,36482,6622,0,4712,25148,22307,2841
12/2/2016 22:00,35533,7492,0,4712,23329,20735,2594
12/2/2016 23:00,33948,7122,0,4712,22114,19563,2551
12/3/2016 0:00,32021,7107,0,4712,20203,17593,2610
12/3/2016 1:00,30418,6723,0,4712,18983,17689,1294
12/3/2016 2:00,29400,6115,0,4712,18573,17267,1306
12/3/2016 3:00,28911,6302,0,4712,17898,16805,1093
12/3/2016 4:00,28804,6406,0,4712,17685,17273,412
12/3/2016 5:00,29064,6302,0,4712,18050,18180,-130
12/3/2016 6:00,29923,6159,0,4712,19052,19574,-522
12/3/2016 7:00,31359,6177,0,4712,20469,20750,-281
12/3/2016 8:00,32977,6249,160,4712,21857,22418,-561
12/3/2016 9:00,34701,5761,282,4712,23946,24214,-268
12/3/2016 10:00,36269,5276,336,4712,25945,25412,533
12/3/2016 11:00,37323,4288,356,4712,27968,26332,1636
12/3/2016 12:00,37518,3335,354,4712,29117,27053,2064
12/3/2016 13:00,37336,2515,339,4712,29770,27140,2630
12/3/2016 14:00,36975,2174,305,4712,29783,26755,3028
12/3/2016 15:00,36648,2582,262,4712,29093,26765,2328
12/3/2016 16:00,36559,2831,215,4712,28800,26760,2040
12/3/2016 17:00,36933,3265,183,4712,28774,28009,765
12/3/2016 18:00,38200,2990,0,4712,30498,27981,2517
12/3/2016 19:00,38551,3069,0,4712,30770,27513,3257
12/3/2016 20:00,37871,2771,0,4712,30389,27290,3099
12/3/2016 21:00,37122,2656,0,4712,29754,26660,3094
12/3/2016 22:00,36076,1717,0,4712,29647,25849,3798
12/3/2016 23:00,34596,1326,0,4712,28558,24482,4076
12/4/2016 0:00,32766,1680,0,4712,26374,22878,3496
12/4/2016 1:00,31058,1415,0,4712,24931,21806,3125
12/4/2016 2:00,29994,1638,0,4712,23645,20480,3165
12/4/2016 3:00,29304,2931,0,4712,21662,19535,2127
12/4/2016 4:00,28986,3670,0,4712,20604,19305,1299
12/4/2016 5:00,29073,4176,0,4712,20185,19248,937
12/4/2016 6:00,29642,4844,0,4712,20086,19683,403
12/4/2016 7:00,30658,5272,0,4712,20674,20752,-78
12/4/2016 8:00,31857,5645,116,4712,21384,21164,220
12/4/2016 9:00,33275,6296,309,4712,21958,22823,-865
12/4/2016 10:00,34761,5671,349,4712,24030,23769,261
12/4/2016 11:00,35528,5580,350,4712,24886,24346,540
12/4/2016 12:00,35928,4725,335,4712,26155,24985,1170
12/4/2016 13:00,35998,3654,313,4712,27319,25512,1807
12/4/2016 14:00,35884,2729,282,4712,28162,25921,2241
12/4/2016 15:00,35730,2398,242,4712,28379,26788,1591
12/4/2016 16:00,35791,1959,199,4712,28921,27576,1345
12/4/2016 17:00,36397,2059,109,4712,29517,28983,534
12/4/2016 18:00,38487,1854,0,4712,31921,29864,2057
12/4/2016 19:00,39610,1977,0,4712,32921,29452,3469
12/4/2016 20:00,39492,2501,0,4712,32279,28431,3848
12/4/2016 21:00,38895,2735,0,4712,31448,26670,4778
12/4/2016 22:00,37571,3466,0,4712,29392,24239,5153
12/4/2016 23:00,35339,4397,0,4712,26231,21926,4305
12/5/2016 0:00,32873,4292,0,4712,23870,20713,3157
12/5/2016 1:00,31168,4120,0,4712,22335,20271,2064
12/5/2016 2:00,30280,3945,0,4712,21622,19904,1718
12/5/2016 3:00,29961,3773,0,4712,21476,20193,1283
12/5/2016 4:00,30113,3990,0,4712,21410,21146,264
12/5/2016 5:00,31130,3678,0,4712,22740,23867,-1127
12/5/2016 6:00,33784,3631,0,4712,25441,26847,-1406
12/5/2016 7:00,37704,3428,0,4712,29563,27624,1939
12/5/2016 8:00,39142,3525,26,4712,30879,27351,3528
12/5/2016 9:00,38903,3584,159,4712,30449,27318,3131
12/5/2016 10:00,39015,3600,205,4712,30498,27022,3476
12/5/2016 11:00,38942,4453,208,4712,29569,26427,3142
12/5/2016 12:00,38598,4627,199,4712,29059,25725,3334
12/5/2016 13:00,38030,4894,186,4712,28238,25314,2924
12/5/2016 14:00,37650,5058,179,4712,27702,25082,2620
12/5/2016 15:00,37357,5414,152,4712,27079,24925,2154
12/5/2016 16:00,37410,5876,118,4712,26704,24877,1827
12/5/2016 17:00,37946,6205,69,4712,26961,26440,521
12/5/2016 18:00,39855,6972,0,4712,28171,26845,1326
12/5/2016 19:00,41432,8132,0,4712,28588,25679,2909
12/5/2016 20:00,41200,8997,0,4712,27491,24368,3123
12/5/2016 21:00,40577,9704,0,4712,26161,22723,3438
12/5/2016 22:00,38820,9715,0,4712,24392,20188,4204
12/5/2016 23:00,36263,10073,0,4712,21478,17712,3766
12/6/2016 0:00,33635,10607,0,4712,18315,15603,2712
12/6/2016 1:00,31890,10307,0,4712,16872,15355,1517
12/6/2016 2:00,31068,10165,0,4712,16191,15278,913
12/6/2016 3:00,30661,10146,0,4712,15803,15288,515
12/6/2016 4:00,30670,10232,0,4712,15726,15889,-163
12/6/2016 5:00,31552,10646,0,4712,16194,17558,-1364
12/6/2016 6:00,34111,11114,0,4712,18285,20621,-2336
12/6/2016 7:00,38224,11401,0,4712,22111,21386,725
12/6/2016 8:00,39143,11258,55,4712,23118,21033,2085
12/6/2016 9:00,38359,10498,123,4712,23026,21264,1762
12/6/2016 10:00,37908,9803,151,4712,23243,22438,805
12/6/2016 11:00,37464,7527,229,4712,24996,24411,585
12/6/2016 12:00,37202,5044,273,4712,27174,26323,851
12/6/2016 13:00,37022,2653,282,4712,29375,28167,1208
12/6/2016 14:00,37033,1268,250,4712,30803,28534,2269
12/6/2016 15:00,36900,1079,254,4712,30855,29015,1840
12/6/2016 16:00,36839,859,221,4712,31048,29380,1668
12/6/2016 17:00,37370,944,132,4712,31582,31223,359
12/6/2016 18:00,39294,1189,0,4712,33393,32235,1158
12/6/2016 19:00,40885,1947,0,4712,34226,31527,2699
12/6/2016 20:00,40692,2673,0,4712,33307,31007,2300
12/6/2016 21:00,40240,2965,0,4712,32563,28878,3685
12/6/2016 22:00,38789,4042,0,4712,30035,25358,4677
12/6/2016 23:00,36404,4389,0,4712,27303,22472,4831
12/7/2016 0:00,33844,4639,0,4712,24493,21042,3451
12/7/2016 1:00,32359,4790,0,4712,22857,20282,2575
12/7/2016 2:00,31690,4624,0,4712,22353,20738,1615
12/7/2016 3:00,31553,4030,0,4712,22812,21335,1477
12/7/2016 4:00,31799,3692,0,4712,23394,22497,897
12/7/2016 5:00,32989,3529,0,4712,24748,25088,-340
12/7/2016 6:00,35594,3534,0,4712,27347,28266,-919
12/7/2016 7:00,39926,3714,0,4712,31499,29886,1613
12/7/2016 8:00,40849,3447,59,4712,32631,30074,2557
12/7/2016 9:00,40136,1521,248,4712,33655,30499,3156
12/7/2016 10:00,39628,1059,318,4712,33539,30100,3439
12/7/2016 11:00,39116,907,319,4712,33178,30081,3097
12/7/2016 12:00,38490,571,296,4712,32911,29546,3365
12/7/2016 13:00,37946,646,274,4712,32314,29041,3273
12/7/2016 14:00,37663,1208,247,4712,31496,27877,3619
12/7/2016 15:00,37314,1992,222,4712,30388,26818,3570
12/7/2016 16:00,37261,3374,189,4712,28986,26171,2815
12/7/2016 17:00,38041,4783,93,4712,28453,26834,1619
12/7/2016 18:00,40418,6364,0,4712,29342,26813,2529
12/7/2016 19:00,41735,8110,0,4712,28913,24705,4208
12/7/2016 20:00,41573,9604,0,4712,27257,23419,3838
12/7/2016 21:00,41155,10466,0,4712,25977,22137,3840
12/7/2016 22:00,39864,10906,0,4712,24247,19651,4596
12/7/2016 23:00,37540,11584,0,4712,21244,16599,4645
12/8/2016 0:00,35143,12092,0,4712,18340,15269,3071
12/8/2016 1:00,33714,11826,0,4712,17176,14673,2503
12/8/2016 2:00,33137,12228,0,4712,16197,14592,1605
12/8/2016 3:00,33136,12615,0,4712,15809,14803,1006
12/8/2016 4:00,33614,12874,0,4712,16028,15647,381
12/8/2016 5:00,35089,13540,0,4712,16837,18978,-2141
12/8/2016 6:00,38104,12588,0,4712,20804,23880,-3076
12/8/2016 7:00,42598,11625,0,4712,26261,26813,-552
12/8/2016 8:00,44412,10798,141,4712,28761,27419,1342
12/8/2016 9:00,44494,10278,270,4712,29234,28250,984
12/8/2016 10:00,44948,9338,305,4712,30593,29174,1419
12/8/2016 11:00,45233,8807,313,4712,31401,30155,1246
12/8/2016 12:00,45346,7820,317,4712,32498,30879,1619
12/8/2016 13:00,45359,6943,302,4712,33403,31641,1762
12/8/2016 14:00,45370,5980,269,4712,34409,32161,2248
12/8/2016 15:00,45302,5788,275,4712,34527,32635,1892
12/8/2016 16:00,45549,5330,230,4712,35277,34394,883
12/8/2016 17:00,46776,4857,135,4712,37072,37172,-100
12/8/2016 18:00,49492,4392,0,4712,40388,39383,1005
12/8/2016 19:00,51017,4100,0,4712,42205,40259,1946
12/8/2016 20:00,50984,3663,0,4712,42609,40183,2426
12/8/2016 21:00,50718,3324,0,4712,42682,38652,4030
12/8/2016 22:00,49376,3288,0,4712,41376,35940,5436
12/8/2016 23:00,46882,3581,0,4712,38589,33246,5343
12/9/2016 0:00,44480,3445,0,4712,36323,31744,4579
12/9/2016 1:00,42974,3544,0,4712,34718,31367,3351
12/9/2016 2:00,42359,3453,0,4712,34194,31304,2890
12/9/2016 3:00,42194,3312,0,4712,34170,31647,2523
12/9/2016 4:00,42487,3600,0,4712,34176,32366,1810
12/9/2016 5:00,43583,3887,0,4712,34984,34439,545
12/9/2016 6:00,46181,3975,0,4712,37494,38957,-1463
12/9/2016 7:00,50079,4107,0,4712,41260,39731,1529
12/9/2016 8:00,50741,3936,70,4712,42023,38543,3480
12/9/2016 9:00,49948,4446,276,4712,40514,37527,2987
12/9/2016 10:00,49461,4714,310,4712,39724,36416,3308
12/9/2016 11:00,48389,4420,308,4712,38949,34893,4056
12/9/2016 12:00,46919,4558,299,4712,37349,32755,4594
12/9/2016 13:00,45230,5204,288,4712,35026,30835,4191
12/9/2016 14:00,43896,5450,272,4712,33463,29937,3526
12/9/2016 15:00,42913,5589,224,4712,32388,29765,2623
12/9/2016 16:00,42536,5587,183,4712,32054,30310,1744
12/9/2016 17:00,43210,5274,97,4712,33128,33042,86
12/9/2016 18:00,45762,5196,0,4712,35854,33957,1897
12/9/2016 19:00,47361,6817,0,4712,35832,32196,3636
12/9/2016 20:00,47132,8236,0,4712,34184,30536,3648
12/9/2016 21:00,46830,9371,0,4712,32747,28988,3759
12/9/2016 22:00,45996,10161,0,4712,31122,26924,4198
12/9/2016 23:00,44290,10968,0,4712,28611,24911,3700
12/10/2016 0:00,42241,11082,0,4712,26447,22791,3656
12/10/2016 1:00,40648,11242,0,4712,24694,21791,2903
12/10/2016 2:00,39691,11141,0,4712,23838,21504,2334
12/10/2016 3:00,39065,11039,0,4712,23314,21417,1897
12/10/2016 4:00,38849,10716,0,4712,23421,21847,1574
12/10/2016 5:00,39223,10865,0,4712,23645,22739,906
12/10/2016 6:00,40292,11096,0,4712,24484,23932,552
12/10/2016 7:00,41848,11164,0,4712,25972,24653,1319
12/10/2016 8:00,43137,10833,23,4712,27569,26443,1126
12/10/2016 9:00,44170,9455,169,4712,29833,27251,2582
12/10/2016 10:00,44505,9545,210,4712,30039,26743,3296
12/10/2016 11:00,43908,9374,254,4712,29568,25202,4366
12/10/2016 12:00,42825,10009,259,4712,27845,22591,5254
12/10/2016 13:00,41440,11296,236,4712,25195,20449,4746
12/10/2016 14:00,40119,11960,249,4712,23198,19376,3822
12/10/2016 15:00,39228,12395,242,4712,21878,19061,2817
12/10/2016 16:00,38908,12493,211,4712,21492,19795,1697
12/10/2016 17:00,39368,12256,115,4712,22286,21802,484
12/10/2016 18:00,41270,12465,0,4712,24093,22331,1762
12/10/2016 19:00,42168,12963,0,4712,24494,21714,2780
12/10/2016 20:00,41738,13147,0,4712,23879,21047,2832
12/10/2016 21:00,41151,13280,0,4712,23159,20080,3079
12/10/2016 22:00,40142,13355,0,4712,22075,18661,3414
12/10/2016 23:00,38433,13281,0,4712,20440,16696,3744
12/11/2016 0:00,36333,13092,0,4712,18528,15145,3383
12/11/2016 1:00,34600,12967,0,4712,16921,14109,2812
12/11/2016 2:00,33322,12968,0,4712,15642,13495,2147
12/11/2016 3:00,32442,12685,0,4712,15045,13160,1885
12/11/2016 4:00,31962,12556,0,4712,14694,13599,1095
12/11/2016 5:00,31929,12593,0,4712,14625,13927,698
12/11/2016 6:00,32347,12426,0,4712,15209,15080,129
12/11/2016 7:00,33078,11949,0,4712,16418,16498,-80
12/11/2016 8:00,33697,11918,10,4712,17056,17713,-657
12/11/2016 9:00,34662,11486,161,4712,18302,18727,-425
12/11/2016 10:00,35358,10961,204,4712,19480,18867,613
12/11/2016 11:00,35333,11116,217,4712,19288,17983,1305
12/11/2016 12:00,34916,11368,198,4712,18639,16730,1909
12/11/2016 13:00,34373,11697,172,4712,17793,16423,1370
12/11/2016 14:00,33858,11069,141,4712,17937,17070,867
12/11/2016 15:00,33419,9512,144,4712,19051,18101,950
12/11/2016 16:00,33242,8131,165,4712,20233,19857,376
12/11/2016 17:00,33579,6266,120,4712,22481,22648,-167
12/11/2016 18:00,35479,6160,0,4712,24608,23572,1036
12/11/2016 19:00,37413,7243,0,4712,25458,22504,2954
12/11/2016 20:00,37428,8006,0,4712,24710,21671,3039
12/11/2016 21:00,36748,8354,0,4712,23682,20814,2868
12/11/2016 22:00,35727,7868,0,4712,23147,19220,3927
12/11/2016 23:00,33713,7906,0,4712,21096,17856,3240
12/12/2016 0:00,31428,6949,0,4712,19767,16909,2858
12/12/2016 1:00,29580,6634,0,4712,18233,16745,1488
12/12/2016 2:00,28743,6046,0,4712,17985,16940,1045
12/12/2016 3:00,28560,5557,0,4712,18291,18168,123
12/12/2016 4:00,28932,4676,0,4712,19543,20165,-622
12/12/2016 5:00,30174,3705,0,4712,21758,23129,-1371
12/12/2016 6:00,33075,3224,0,4712,25140,27166,-2026
12/12/2016 7:00,37411,2939,0,4712,29760,28680,1080
12/12/2016 8:00,39010,2509,0,4712,31789,28996,2793
12/12/2016 9:00,38690,1439,68,4712,32470,29261,3209
12/12/2016 10:00,38453,1212,128,4712,32401,29034,3367
12/12/2016 11:00,37999,1330,101,4712,31856,28489,3367
12/12/2016 12:00,37366,1332,92,4712,31230,27926,3304
12/12/2016 13:00,36713,1291,74,4712,30636,27447,3189
12/12/2016 14:00,36292,1406,66,4712,30108,26852,3256
12/12/2016 15:00,35908,1726,70,4712,29400,26779,2621
12/12/2016 16:00,35708,1910,95,4712,28990,27189,1801
12/12/2016 17:00,35993,1796,32,4712,29452,28158,1294
12/12/2016 18:00,37998,3155,0,4712,30131,28409,1722
12/12/2016 19:00,39829,4687,0,4712,30429,26698,3731
12/12/2016 20:00,39792,6630,0,4712,28450,25101,3349
12/12/2016 21:00,39368,7375,0,4712,27281,23938,3343
12/12/2016 22:00,38067,6859,0,4712,26496,21544,4952
12/12/2016 23:00,35601,6475,0,4712,24414,19298,5116
12/13/2016 0:00,32932,6780,0,4712,21440,17569,3871
12/13/2016 1:00,31020,7170,0,4712,19139,16506,2633
12/13/2016 2:00,30074,6794,0,4712,18569,16660,1909
12/13/2016 3:00,29580,6198,0,4712,18670,17162,1508
12/13/2016 4:00,29615,5691,0,4712,19212,17966,1246
12/13/2016 5:00,30275,6141,0,4712,19421,19864,-443
12/13/2016 6:00,32560,6265,0,4712,21583,22878,-1295
12/13/2016 7:00,36320,6828,0,4712,24780,23965,815
12/13/2016 8:00,37471,7376,13,4712,25370,22987,2383
12/13/2016 9:00,37135,6831,176,4712,25415,23718,1697
12/13/2016 10:00,37498,6541,225,4712,26020,24723,1297
12/13/2016 11:00,37837,5582,220,4712,27323,25523,1800
12/13/2016 12:00,37843,4868,232,4712,28030,26131,1899
12/13/2016 13:00,37517,3193,250,4712,29363,27362,2001
12/13/2016 14:00,37256,2187,230,4712,30126,27667,2459
12/13/2016 15:00,37008,1893,242,4712,30161,27406,2755
12/13/2016 16:00,36828,2097,218,4712,29801,27588,2213
12/13/2016 17:00,37067,1821,162,4712,30371,28794,1577
12/13/2016 18:00,38686,2668,0,4712,31306,29779,1527
12/13/2016 19:00,40508,3711,0,4712,32085,28314,3771
12/13/2016 20:00,40300,4640,0,4712,30948,27570,3378
12/13/2016 21:00,39897,4624,0,4712,30561,26328,4233
12/13/2016 22:00,38561,4299,0,4712,29550,24326,5224
12/13/2016 23:00,36251,3839,0,4712,27701,22276,5425
12/14/2016 0:00,33724,3499,0,4712,25513,21232,4281
12/14/2016 1:00,31941,2983,0,4712,24246,20950,3296
12/14/2016 2:00,31174,2544,0,4712,23918,21213,2705
12/14/2016 3:00,30919,2487,0,4712,23720,21554,2166
12/14/2016 4:00,31202,2286,0,4712,24205,22912,1293
12/14/2016 5:00,32280,1946,0,4712,25622,24621,1001
12/14/2016 6:00,34839,2435,0,4712,27691,27939,-248
12/14/2016 7:00,38804,2373,0,4712,31719,29805,1914
12/14/2016 8:00,40107,1758,88,4712,33549,30134,3415
12/14/2016 9:00,39684,948,313,4712,33711,30698,3013
12/14/2016 10:00,39595,348,355,4712,34180,30534,3646
12/14/2016 11:00,39374,536,324,4712,33802,29813,3989
12/14/2016 12:00,38898,1281,337,4712,32569,28123,4446
12/14/2016 13:00,38060,1949,322,4712,31078,26906,4172
12/14/2016 14:00,37342,2132,289,4712,30210,26084,4126
12/14/2016 15:00,36757,2684,252,4712,29108,25622,3486
12/14/2016 16:00,36711,3387,261,4712,28351,25767,2584
12/14/2016 17:00,37325,4012,169,4712,28432,26982,1450
12/14/2016 18:00,39449,5366,0,4712,29370,27212,2158
12/14/2016 19:00,41269,6930,0,4712,29627,26450,3177
12/14/2016 20:00,41246,7293,0,4712,29241,26152,3089
12/14/2016 21:00,41045,7030,0,4712,29303,25470,3833
12/14/2016 22:00,39777,5893,0,4712,29172,24425,4747
12/14/2016 23:00,37411,5098,0,4712,27601,22407,5194
12/15/2016 0:00,34823,5177,0,4712,24933,21244,3689
12/15/2016 1:00,33091,5303,0,4712,23076,20366,2710
12/15/2016 2:00,32240,5243,0,4712,22285,20511,1774
12/15/2016 3:00,31956,4462,0,4712,22782,21513,1269
12/15/2016 4:00,32153,3746,0,4712,23694,23252,442
12/15/2016 5:00,33369,3659,0,4712,24998,25947,-949
12/15/2016 6:00,36098,3076,0,4712,28310,29718,-1408
12/15/2016 7:00,40288,3212,0,4712,32364,30790,1574
12/15/2016 8:00,41885,3079,23,4712,34072,30785,3287
12/15/2016 9:00,41828,3418,149,4712,33549,30654,2895
12/15/2016 10:00,41970,3583,177,4712,33497,30445,3052
12/15/2016 11:00,41938,4056,183,4712,32988,29690,3298
12/15/2016 12:00,41534,3998,183,4712,32642,28770,3872
12/15/2016 13:00,40810,4355,174,4712,31569,27394,4175
12/15/2016 14:00,40196,4722,166,4712,30596,26691,3905
12/15/2016 15:00,39642,5020,177,4712,29733,25894,3839
12/15/2016 16:00,39313,5637,146,4712,28819,26309,2510
12/15/2016 17:00,39778,5882,136,4712,29048,27414,1634
12/15/2016 18:00,41734,6990,0,4712,30032,27516,2516
12/15/2016 19:00,43247,8502,0,4712,30033,25719,4314
12/15/2016 20:00,43094,10478,0,4712,27904,24252,3652
12/15/2016 21:00,42774,11554,0,4712,26507,22500,4007
12/15/2016 22:00,41473,11777,0,4712,24984,19754,5230
12/15/2016 23:00,38911,11906,0,4712,22294,17744,4550
12/16/2016 0:00,36326,11888,0,4712,19726,16121,3605
12/16/2016 1:00,34364,12190,0,4712,17462,15116,2346
12/16/2016 2:00,33320,12613,0,4712,15995,14268,1727
12/16/2016 3:00,32755,12786,0,4712,15257,14112,1145
12/16/2016 4:00,32675,12783,0,4712,15180,14544,636
12/16/2016 5:00,33391,12762,0,4712,15918,16639,-721
12/16/2016 6:00,35627,12628,0,4712,18287,19993,-1706
12/16/2016 7:00,39162,12312,0,4712,22138,20915,1223
12/16/2016 8:00,40276,12315,27,4712,23222,20373,2849
12/16/2016 9:00,39862,12071,186,4712,22893,20231,2662
12/16/2016 10:00,39660,12015,247,4712,22686,20184,2502
12/16/2016 11:00,39552,11865,276,4712,22699,19575,3124
12/16/2016 12:00,38990,12238,280,4712,21759,18862,2897
12/16/2016 13:00,38398,12329,310,4712,21046,18910,2136
12/16/2016 14:00,37865,12081,286,4712,20785,18349,2436
12/16/2016 15:00,37212,12716,253,4712,19530,17609,1921
12/16/2016 16:00,36664,12408,216,4712,19329,18353,976
12/16/2016 17:00,36468,11345,134,4712,20276,20081,195
12/16/2016 18:00,37766,11846,0,4712,21208,19898,1310
12/16/2016 19:00,38797,12166,0,4712,21919,19300,2619
12/16/2016 20:00,38089,12491,0,4712,20885,18082,2803
12/16/2016 21:00,37393,13689,0,4712,18993,16174,2819
12/16/2016 22:00,36449,14361,0,4712,17377,14563,2814
12/16/2016 23:00,34767,14335,0,4712,15719,13463,2256
12/17/2016 0:00,32570,13293,0,4712,14565,12835,1730
12/17/2016 1:00,30662,13017,0,4712,12933,12357,576
12/17/2016 2:00,29510,12370,0,4712,12428,11857,571
12/17/2016 3:00,28812,12147,0,4712,11953,11806,147
12/17/2016 4:00,28431,12163,0,4712,11556,11932,-376
12/17/2016 5:00,28510,12025,0,4712,11773,12242,-469
12/17/2016 6:00,29146,12651,0,4712,11784,12658,-874
12/17/2016 7:00,30426,13067,0,4712,12647,13818,-1171
12/17/2016 8:00,31763,13343,86,4712,13622,14786,-1164
12/17/2016 9:00,33284,12874,318,4712,15380,16505,-1125
12/17/2016 10:00,34761,11609,359,4712,18081,17704,377
12/17/2016 11:00,35760,11411,329,4712,19308,17794,1514
12/17/2016 12:00,36284,12050,338,4712,19184,17678,1506
12/17/2016 13:00,36453,12902,329,4712,18510,16847,1663
12/17/2016 14:00,36310,13575,293,4712,17730,16405,1325
12/17/2016 15:00,36207,14156,253,4712,17086,16951,135
12/17/2016 16:00,36444,14312,209,4712,17211,18250,-1039
12/17/2016 17:00,37486,14949,194,4712,17631,20300,-2669
12/17/2016 18:00,40033,14674,0,4712,20647,21786,-1139
12/17/2016 19:00,42328,14778,0,4712,22838,21963,875
12/17/2016 20:00,42774,14419,0,4712,23643,22428,1215
12/17/2016 21:00,42964,13794,0,4712,24459,23312,1147
12/17/2016 22:00,43164,12776,0,4712,25676,23510,2166
12/17/2016 23:00,42352,11846,0,4712,25794,23407,2387
12/18/2016 0:00,40939,10269,0,4712,25958,23676,2282
12/18/2016 1:00,40194,9773,0,4712,25709,24483,1226
12/18/2016 2:00,40163,8669,0,4712,26783,25299,1484
12/18/2016 3:00,40666,8279,0,4712,27674,26645,1029
12/18/2016 4:00,41462,7428,0,4712,29321,28290,1031
12/18/2016 5:00,42469,6179,0,4712,31578,30163,1415
12/18/2016 6:00,43959,5898,0,4712,33349,32723,626
12/18/2016 7:00,46016,5167,0,4712,36137,35397,740
12/18/2016 8:00,48213,4944,51,4712,38507,37129,1378
12/18/2016 9:00,50305,5238,277,4712,40079,38246,1833
12/18/2016 10:00,51768,5233,318,4712,41505,37741,3764
12/18/2016 11:00,51661,5415,329,4712,41205,36702,4503
12/18/2016 12:00,50655,4856,328,4712,40759,35910,4849
12/18/2016 13:00,49279,4432,301,4712,39834,34632,5202
12/18/2016 14:00,47936,4269,266,4712,38689,33603,5086
12/18/2016 15:00,46840,4110,236,4712,37782,33892,3890
12/18/2016 16:00,46671,4053,257,4712,37649,34899,2750
12/18/2016 17:00,47550,3682,189,4712,38967,38057,910
12/18/2016 18:00,50594,3561,0,4712,42321,40786,1535
12/18/2016 19:00,53444,3954,0,4712,44777,40904,3873
12/18/2016 20:00,54075,4478,0,4712,44885,40851,4034
12/18/2016 21:00,54096,4398,0,4712,44986,40154,4832
12/18/2016 22:00,53482,4592,0,4712,44178,38717,5461
12/18/2016 23:00,51945,4531,0,4712,42702,37261,5441
12/19/2016 0:00,50199,4149,0,4712,41338,36283,5055
12/19/2016 1:00,48906,3963,0,4712,40230,36161,4069
12/19/2016 2:00,48524,3716,0,4712,40096,36541,3555
12/19/2016 3:00,48562,3397,0,4712,40453,36884,3569
12/19/2016 4:00,49041,3730,0,4712,40599,37734,2865
12/19/2016 5:00,50389,4183,0,4712,41494,39975,1519
12/19/2016 6:00,53056,3801,0,4712,44543,43667,876
12/19/2016 7:00,56328,3374,0,4712,48242,45963,2279
12/19/2016 8:00,57924,3171,57,4712,49983,45926,4057
12/19/2016 9:00,57310,2872,251,4712,49476,45135,4341
12/19/2016 10:00,55886,1875,282,4712,49017,43947,5070
12/19/2016 11:00,54078,1823,277,4712,47266,41680,5586
12/19/2016 12:00,51687,2049,204,4712,44722,38234,6488
12/19/2016 13:00,49181,2726,229,4712,41514,35593,5921
12/19/2016 14:00,47097,3234,189,4712,38962,34037,4925
12/19/2016 15:00,45664,3579,204,4712,37169,33430,3739
12/19/2016 16:00,45097,3542,153,4712,36690,33742,2948
12/19/2016 17:00,45759,3589,77,4712,37380,35987,1393
12/19/2016 18:00,48731,4177,0,4712,39843,37929,1914
12/19/2016 19:00,51359,4784,0,4712,41862,37866,3996
12/19/2016 20:00,51641,5591,0,4712,41337,36290,5047
12/19/2016 21:00,51462,6969,0,4712,39781,34404,5377
12/19/2016 22:00,50336,7743,0,4712,37881,30815,7066
12/19/2016 23:00,47931,8835,0,4712,34384,28577,5807
12/20/2016 0:00,45615,9274,0,4712,31630,27328,4302
12/20/2016 1:00,43867,9248,0,4712,29906,27077,2829
12/20/2016 2:00,43057,9113,0,4712,29232,26922,2310
12/20/2016 3:00,42730,9409,0,4712,28609,27116,1493
12/20/2016 4:00,43042,9234,0,4712,29097,28254,843
12/20/2016 5:00,44054,8688,0,4712,30654,30255,399
12/20/2016 6:00,46241,8674,0,4712,32854,32148,706
12/20/2016 7:00,49240,9323,0,4712,35205,33222,1983
12/20/2016 8:00,50258,8813,0,4712,36732,33499,3233
12/20/2016 9:00,49338,6944,44,4712,37639,33650,3989
12/20/2016 10:00,47684,5197,93,4712,37682,33216,4466
12/20/2016 11:00,45681,3368,94,4712,37507,31985,5522
12/20/2016 12:00,43386,2932,101,4712,35640,30650,4990
12/20/2016 13:00,41125,2362,93,4712,33958,29256,4702
12/20/2016 14:00,39469,2324,76,4712,32357,28683,3674
12/20/2016 15:00,38182,1533,54,4712,31884,28269,3615
12/20/2016 16:00,37486,1374,44,4712,31356,28509,2847
12/20/2016 17:00,37665,1680,13,4712,31259,29773,1486
12/20/2016 18:00,39912,2524,0,4712,32676,31138,1538
12/20/2016 19:00,42486,3899,0,4712,33875,30716,3159
12/20/2016 20:00,42781,4776,0,4712,33293,29964,3329
12/20/2016 21:00,42716,5416,0,4712,32588,28134,4454
12/20/2016 22:00,41885,6872,0,4712,30300,25400,4900
12/20/2016 23:00,40070,7761,0,4712,27597,23278,4319
12/21/2016 0:00,37931,8072,0,4712,25146,21586,3560
12/21/2016 1:00,36306,8198,0,4712,23396,20681,2715
12/21/2016 2:00,35571,8661,0,4712,22197,20087,2110
12/21/2016 3:00,35301,9202,0,4712,21388,20137,1251
12/21/2016 4:00,35595,8795,0,4712,22088,21661,427
12/21/2016 5:00,36636,8032,0,4712,23892,24043,-151
12/21/2016 6:00,38895,8329,0,4712,25854,26117,-263
12/21/2016 7:00,41831,8817,0,4712,28302,26938,1364
12/21/2016 8:00,43080,8919,0,4712,29449,26496,2953
12/21/2016 9:00,42388,8852,135,4712,28689,25642,3047
12/21/2016 10:00,40967,7402,166,4712,28686,25793,2893
12/21/2016 11:00,39492,5666,209,4712,28905,25242,3663
12/21/2016 12:00,38215,5880,218,4712,27406,23430,3976
12/21/2016 13:00,37177,6305,204,4712,25956,22372,3584
12/21/2016 14:00,36332,6289,203,4712,25129,22208,2921
12/21/2016 15:00,35706,5754,186,4712,25054,22671,2383
12/21/2016 16:00,35419,5155,161,4712,25391,22912,2479
12/21/2016 17:00,35541,5311,106,4712,25413,23822,1591
12/21/2016 18:00,37205,6211,0,4712,26282,24631,1651
12/21/2016 19:00,39018,6826,0,4712,27479,23662,3817
12/21/2016 20:00,38789,8049,0,4712,26028,22579,3449
12/21/2016 21:00,38311,9897,0,4712,23703,20541,3162
12/21/2016 22:00,37397,10611,0,4712,22074,18708,3366
12/21/2016 23:00,35701,10948,0,4712,20040,16768,3272
12/22/2016 0:00,33495,10680,0,4712,18103,15295,2808
12/22/2016 1:00,31817,10561,0,4712,16544,15151,1393
12/22/2016 2:00,30826,10256,0,4712,15858,15454,404
12/22/2016 3:00,30396,9573,0,4712,16111,16012,99
12/22/2016 4:00,30459,8821,0,4712,16926,17563,-637
12/22/2016 5:00,31351,8038,0,4712,18601,19724,-1123
12/22/2016 6:00,33253,7114,0,4712,21427,22795,-1368
12/22/2016 7:00,36014,6370,0,4712,24932,24976,-44
12/22/2016 8:00,37655,5481,38,4712,27425,26077,1348
12/22/2016 9:00,38070,4687,238,4712,28433,26589,1844
12/22/2016 10:00,38250,4497,242,4712,28800,26403,2397
12/22/2016 11:00,38042,4499,238,4712,28593,26518,2075
12/22/2016 12:00,37465,2920,209,4712,29624,27377,2247
12/22/2016 13:00,36717,1618,197,4712,30191,27801,2390
12/22/2016 14:00,36303,1213,154,4712,30224,27570,2654
12/22/2016 15:00,35852,1179,142,4712,29818,27210,2608
12/22/2016 16:00,35538,1554,116,4712,29156,26824,2332
12/22/2016 17:00,35649,1651,61,4712,29225,28048,1177
12/22/2016 18:00,37488,1893,0,4712,30883,28958,1925
12/22/2016 19:00,39160,2179,0,4712,32269,28583,3686
12/22/2016 20:00,39127,2020,0,4712,32396,28371,4025
12/22/2016 21:00,38776,1910,0,4712,32154,27657,4497
12/22/2016 22:00,38091,1892,0,4712,31487,26218,5269
12/22/2016 23:00,36528,1804,0,4712,30012,24470,5542
12/23/2016 0:00,34604,1966,0,4712,27926,23066,4860
12/23/2016 1:00,32828,2306,0,4712,25810,21995,3815
12/23/2016 2:00,31765,2979,0,4712,24074,20960,3114
12/23/2016 3:00,31000,3045,0,4712,23244,20664,2580
12/23/2016 4:00,30697,3304,0,4712,22681,20617,2064
12/23/2016 5:00,31023,4635,0,4712,21676,20381,1295
12/23/2016 6:00,32109,5930,0,4712,21467,20505,962
12/23/2016 7:00,33782,7166,0,4712,21905,20397,1508
12/23/2016 8:00,35104,7826,48,4712,22519,21504,1015
12/23/2016 9:00,36092,7023,211,4712,24146,23051,1095
12/23/2016 10:00,37016,6370,231,4712,25703,23473,2230
12/23/2016 11:00,37528,7014,272,4712,25529,22562,2967
12/23/2016 12:00,37613,8175,265,4712,24461,21826,2635
12/23/2016 13:00,37351,8605,251,4712,23783,21618,2165
12/23/2016 14:00,37063,8098,207,4712,24045,22147,1898
12/23/2016 15:00,36718,6479,152,4712,25375,22552,2823
12/23/2016 16:00,36568,5954,187,4712,25715,23151,2564
12/23/2016 17:00,36626,5250,120,4712,26544,24805,1739
12/23/2016 18:00,37697,5787,0,4712,27198,24954,2244
12/23/2016 19:00,38668,6339,0,4712,27617,23775,3842
12/23/2016 20:00,38095,6942,0,4712,26441,23075,3366
12/23/2016 21:00,37464,6809,0,4712,25943,22843,3100
12/23/2016 22:00,36521,6699,0,4712,25110,21481,3629
12/23/2016 23:00,35084,6542,0,4712,23830,20358,3472
12/24/2016 0:00,33163,5735,0,4712,22716,19310,3406
12/24/2016 1:00,31131,5251,0,4712,21168,18632,2536
12/24/2016 2:00,29749,4733,0,4712,20304,18208,2096
12/24/2016 3:00,28696,4413,0,4712,19572,18059,1513
12/24/2016 4:00,28133,3972,0,4712,19449,18277,1172
12/24/2016 5:00,27993,3336,0,4712,19945,19089,856
12/24/2016 6:00,28383,3371,0,4712,20301,19906,395
12/24/2016 7:00,29274,3163,0,4712,21398,20772,626
12/24/2016 8:00,30276,3223,60,4712,22280,22125,155
12/24/2016 9:00,31758,2876,284,4712,23886,23831,55
12/24/2016 10:00,33557,2822,314,4712,25709,24454,1255
12/24/2016 11:00,34728,3733,284,4712,25999,23854,2145
12/24/2016 12:00,35434,5205,283,4712,25234,22112,3122
12/24/2016 13:00,35802,7195,255,4712,23640,20638,3002
12/24/2016 14:00,35939,8665,233,4712,22329,20018,2311
12/24/2016 15:00,36041,8713,216,4712,22401,19617,2784
12/24/2016 16:00,36023,9898,195,4712,21218,19221,1997
12/24/2016 17:00,35915,10198,196,4712,20809,19965,844
12/24/2016 18:00,36655,10567,0,4712,21376,19333,2043
12/24/2016 19:00,37440,12424,0,4712,20304,17271,3033
12/24/2016 20:00,36546,13576,0,4712,18258,15879,2379
12/24/2016 21:00,35693,14313,0,4712,16668,15137,1531
12/24/2016 22:00,34866,14488,0,4712,15665,13919,1746
12/24/2016 23:00,33763,15266,0,4712,13785,12531,1254
12/25/2016 0:00,32261,14723,0,4712,12827,11673,1154
12/25/2016 1:00,30542,13872,0,4712,11958,11291,667
12/25/2016 2:00,29204,12836,0,4712,11656,11177,479
12/25/2016 3:00,28088,11860,0,4712,11516,11134,382
12/25/2016 4:00,27331,11140,0,4712,11479,11151,328
12/25/2016 5:00,26989,10781,0,4712,11496,11374,122
12/25/2016 6:00,27076,10969,0,4712,11395,11163,232
12/25/2016 7:00,27736,11906,0,4712,11119,11171,-52
12/25/2016 8:00,28702,12710,26,4712,11254,11224,30
12/25/2016 9:00,30306,14630,219,4712,10745,11811,-1066
12/25/2016 10:00,32296,15391,212,4712,11981,12389,-408
12/25/2016 11:00,33726,15722,212,4712,13081,13712,-631
12/25/2016 12:00,34768,14905,198,4712,14953,14951,2
12/25/2016 13:00,35223,12798,175,4712,17538,16383,1155
12/25/2016 14:00,35097,11117,161,4712,19107,17312,1795
12/25/2016 15:00,34764,9784,132,4712,20136,17861,2275
12/25/2016 16:00,34424,9088,98,4712,20527,17935,2592
12/25/2016 17:00,34044,9026,65,4712,20240,18598,1642
12/25/2016 18:00,34593,8100,0,4712,21781,20178,1603
12/25/2016 19:00,35804,7731,0,4712,23361,20372,2989
12/25/2016 20:00,35532,7073,0,4712,23746,20334,3412
12/25/2016 21:00,35041,6836,0,4712,23493,19959,3534
12/25/2016 22:00,34431,6961,0,4712,22758,19145,3613
12/25/2016 23:00,33312,6862,0,4712,21738,17868,3870
12/26/2016 0:00,31643,7155,0,4712,19776,16426,3350
12/26/2016 1:00,29964,6947,0,4712,18306,15562,2744
12/26/2016 2:00,28678,7063,0,4712,16902,15215,1687
12/26/2016 3:00,27883,6783,0,4712,16388,15288,1100
12/26/2016 4:00,27522,6341,0,4712,16469,15552,917
12/26/2016 5:00,27605,6296,0,4712,16597,15833,764
12/26/2016 6:00,28218,6292,0,4712,17214,16768,446
12/26/2016 7:00,29163,6311,0,4712,18140,17638,502
12/26/2016 8:00,29865,6185,0,4712,18968,18512,456
12/26/2016 9:00,30906,5765,13,4712,20417,20453,-36
12/26/2016 10:00,32778,5653,55,4712,22357,22273,84
12/26/2016 11:00,34511,4968,120,4712,24711,23809,902
12/26/2016 12:00,35897,4300,193,4712,26692,24877,1815
12/26/2016 13:00,36610,3897,186,4712,27815,25689,2126
12/26/2016 14:00,37135,3311,190,4712,28922,26505,2417
12/26/2016 15:00,37333,2991,156,4712,29474,26425,3049
12/26/2016 16:00,37363,2840,106,4712,29705,26681,3024
12/26/2016 17:00,37043,2379,27,4712,29925,27095,2830
12/26/2016 18:00,37847,2555,0,4712,30579,28128,2451
12/26/2016 19:00,39109,3244,0,4712,31153,27773,3380
12/26/2016 20:00,38530,3055,0,4712,30763,27334,3429
12/26/2016 21:00,37491,2441,0,4712,30338,26334,4004
12/26/2016 22:00,36351,2267,0,4712,29372,24396,4976
12/26/2016 23:00,34463,2536,0,4712,27215,22277,4938
12/27/2016 0:00,32363,2416,0,4712,25235,20695,4540
12/27/2016 1:00,30268,2321,0,4712,23234,19864,3370
12/27/2016 2:00,28929,2523,0,4712,21694,18883,2811
12/27/2016 3:00,28100,2889,0,4712,20499,18715,1784
12/27/2016 4:00,27823,2609,0,4712,20502,19412,1090
12/27/2016 5:00,28197,2115,0,4712,21370,20991,379
12/27/2016 6:00,29533,1969,0,4712,22852,22266,586
12/27/2016 7:00,31559,2332,0,4712,24516,23389,1127
12/27/2016 8:00,33075,2482,0,4712,25880,24391,1489
12/27/2016 9:00,34121,2181,17,4712,27211,25879,1332
12/27/2016 10:00,35395,1447,51,4712,29185,26665,2520
12/27/2016 11:00,36498,1426,71,4712,30289,27375,2914
12/27/2016 12:00,37326,1466,74,4712,31074,27293,3781
12/27/2016 13:00,37843,1951,69,4712,31112,27308,3804
12/27/2016 14:00,38335,2789,89,4712,30745,26958,3787
12/27/2016 15:00,38582,3510,113,4712,30247,26765,3482
12/27/2016 16:00,38501,3968,91,4712,29730,26343,3387
12/27/2016 17:00,38160,3784,72,4712,29592,26666,2926
12/27/2016 18:00,38841,4542,0,4712,29587,26287,3300
12/27/2016 19:00,40100,5896,0,4712,29491,24847,4644
12/27/2016 20:00,39346,6965,0,4712,27670,23164,4506
12/27/2016 21:00,38285,8478,0,4712,25094,20780,4314
12/27/2016 22:00,36799,9851,0,4712,22237,18107,4130
12/27/2016 23:00,34774,10716,0,4712,19346,15852,3494
12/28/2016 0:00,32379,10610,0,4712,17057,14371,2686
12/28/2016 1:00,30417,10446,0,4712,15259,13313,1946
12/28/2016 2:00,29140,10065,0,4712,14363,12820,1543
12/28/2016 3:00,28399,10400,0,4712,13287,12484,803
12/28/2016 4:00,28161,10266,0,4712,13183,12990,193
12/28/2016 5:00,28518,10234,0,4712,13572,14247,-675
12/28/2016 6:00,29799,10262,0,4712,14825,16339,-1514
12/28/2016 7:00,31703,9836,0,4712,17155,17959,-804
12/28/2016 8:00,32959,9178,28,4712,19042,19314,-272
12/28/2016 9:00,33858,8188,230,4712,20728,20749,-21
12/28/2016 10:00,34999,6934,284,4712,23069,22160,909
12/28/2016 11:00,36168,6955,293,4712,24208,23830,378
12/28/2016 12:00,37285,5768,292,4712,26512,25109,1403
12/28/2016 13:00,38234,5148,273,4712,28101,26331,1770
12/28/2016 14:00,39126,4321,257,4712,29835,27685,2150
12/28/2016 15:00,39701,3901,239,4712,30848,28070,2778
12/28/2016 16:00,39885,3412,212,4712,31550,28318,3232
12/28/2016 17:00,39591,3362,147,4712,31370,27805,3565
12/28/2016 18:00,39889,4469,0,4712,30708,28212,2496
12/28/2016 19:00,40750,5019,0,4712,31019,26001,5018
12/28/2016 20:00,39688,6301,0,4712,28675,23983,4692
12/28/2016 21:00,38509,7362,0,4712,26435,21916,4519
12/28/2016 22:00,37013,7939,0,4712,24362,19669,4693
12/28/2016 23:00,34890,8399,0,4712,21780,17171,4609
12/29/2016 0:00,32428,8960,0,4712,18756,14924,3832
12/29/2016 1:00,30391,9765,0,4712,15914,13571,2343
12/29/2016 2:00,29242,9975,0,4712,14554,12832,1722
12/29/2016 3:00,28435,10119,0,4712,13604,12339,1265
12/29/2016 4:00,28158,10425,0,4712,13021,12351,670
12/29/2016 5:00,28550,10699,0,4712,13138,13711,-573
12/29/2016 6:00,29875,10415,0,4712,14748,15352,-604
12/29/2016 7:00,31947,10340,0,4712,16895,16653,242
12/29/2016 8:00,33154,9552,2,4712,18889,17752,1137
12/29/2016 9:00,33983,8917,129,4712,20226,18811,1415
12/29/2016 10:00,34831,9222,146,4712,20751,18633,2118
12/29/2016 11:00,35495,10703,190,4712,19889,17910,1979
12/29/2016 12:00,35641,10547,212,4712,20170,18143,2027
12/29/2016 13:00,35388,9355,221,4712,21100,19231,1869
12/29/2016 14:00,34986,7641,207,4712,22426,20067,2359
12/29/2016 15:00,34602,6750,175,4712,22965,20855,2110
12/29/2016 16:00,34224,5568,181,4712,23763,22062,1701
12/29/2016 17:00,34267,4460,122,4712,24973,24645,328
12/29/2016 18:00,36083,3768,0,4712,27603,26517,1086
12/29/2016 19:00,38061,3949,0,4712,29400,25962,3438
12/29/2016 20:00,37916,3980,0,4712,29223,25869,3354
12/29/2016 21:00,37578,4053,0,4712,28813,24889,3924
12/29/2016 22:00,36654,4196,0,4712,27746,23113,4633
12/29/2016 23:00,34995,4652,0,4712,25632,21142,4490
12/30/2016 0:00,33040,4616,0,4712,23712,19871,3841
12/30/2016 1:00,31485,4799,0,4712,21975,19002,2973
12/30/2016 2:00,30689,5052,0,4712,20925,18448,2477
12/30/2016 3:00,30341,5656,0,4712,19973,17971,2002
12/30/2016 4:00,30405,6415,0,4712,19277,18091,1186
12/30/2016 5:00,31071,6813,0,4712,19546,18850,696
12/30/2016 6:00,32724,7413,0,4712,20599,20270,329
12/30/2016 7:00,35127,7897,0,4712,22518,21513,1005
12/30/2016 8:00,36928,7927,1,4712,24288,22142,2146
12/30/2016 9:00,37704,8001,81,4712,24910,22508,2402
12/30/2016 10:00,38049,7538,127,4712,25672,21936,3736
12/30/2016 11:00,37926,8857,168,4712,24189,20382,3807
12/30/2016 12:00,37608,10389,151,4712,22356,19150,3206
12/30/2016 13:00,36985,11087,126,4712,21060,18774,2286
12/30/2016 14:00,36618,11030,119,4712,20758,18374,2384
12/30/2016 15:00,36494,11441,85,4712,20256,17800,2456
12/30/2016 16:00,36609,12381,65,4712,19451,17924,1527
12/30/2016 17:00,37241,12630,33,4712,19866,19785,81
12/30/2016 18:00,39060,12134,0,4712,22214,20491,1723
12/30/2016 19:00,40174,12912,0,4712,22549,19932,2617
12/30/2016 20:00,39775,13033,0,4712,22031,19432,2599
12/30/2016 21:00,39175,13349,0,4712,21115,18157,2958
12/30/2016 22:00,38129,13509,0,4712,19908,16417,3491
12/30/2016 23:00,36642,13681,0,4712,18250,15095,3155
12/31/2016 0:00,34694,13418,0,4712,16564,14185,2379
12/31/2016 1:00,33117,13084,0,4712,15321,14123,1198
12/31/2016 2:00,31940,12538,0,4712,14689,15444,-755
12/31/2016 3:00,30969,11814,0,4712,14444,15988,-1544
12/31/2016 4:00,30485,11551,0,4712,14222,16640,-2418
12/31/2016 5:00,30409,11215,0,4712,14482,17261,-2779
12/31/2016 6:00,30827,11228,0,4712,14887,17801,-2914
12/31/2016 7:00,31770,10626,0,4712,16432,18274,-1842
12/31/2016 8:00,32720,10698,14,4712,17296,18647,-1351
12/31/2016 9:00,33563,9683,19,4712,19149,19533,-384
12/31/2016 10:00,34354,8200,67,4712,21375,20470,905
12/31/2016 11:00,34520,6877,109,4712,22822,20559,2263
12/31/2016 12:00,34182,5720,93,4712,23657,20912,2745
12/31/2016 13:00,33515,4828,74,4712,23901,21187,2714
12/31/2016 14:00,32744,3695,54,4712,24283,21004,3279
12/31/2016 15:00,32450,3012,39,4712,24688,20565,4123
12/31/2016 16:00,32454,2624,17,4712,25101,20286,4815
12/31/2016 17:00,32695,2619,4,4712,25360,20772,4588
12/31/2016 18:00,34078,2805,0,4712,26562,21484,5078
12/31/2016 19:00,35704,3341,0,4712,27651,20248,7403
12/31/2016 20:00,34899,3980,0,4712,26206,18908,7298
12/31/2016 21:00,33729,4017,0,4712,25000,18678,6322
12/31/2016 22:00,32538,3438,0,4712,24388,19269,5119
12/31/2016 23:00,31394,2490,0,4712,24192,19737,4455
